#############################################################################
##
## Last update: December 4, 2005
##
## Journal abbreviations list readable by JabRef. JabRef versions
## from 2.0 and upward can download and use this list for automatically
## abbreviating and unabbreviating journal names. To access this function,
## choose Tools -> Manage journal abbreviations.
##
#############################################################################
Accounts of Chemical Research=Acc. Chem. Res.;ACHRE4;M
ACS Symposium Series=ACS Symp. Ser.;ACSMC8;IRR
Acta Biochimica Polonica=Acta Biochim. Pol.;ABPLAF;Q
Acta Chimica Slovenica=Acta Chim. Slov.;ACSLE7;Q
Acta Crystallographica, Section A: Foundations of Crystallography=Acta Crystallogr., Sect. A: Found. Crystallogr.;ACACEQ;BM
Acta Crystallographica, Section B: Structural Science=Acta Crystallogr., Sect. B: Struct. Sci.;ASBSDK;BM
Acta Crystallographica, Section C: Crystal Structure Communications=Acta Crystallogr., Sect. C: Cryst. Struct. Commun.;ACSCEE;M
Acta Crystallographica, Section D: Biological Crystallography=Acta Crystallogr., Sect. D: Biol. Crystallogr.;ABCRE6;M
Acta Crystallographica, Section E: Structure Reports Online=Acta Crystallogr., Sect. E: Struct. Rep. Online;ACSEBH;M
Acta Crystallographica, Section F: Structural Biology and Crystallization Communications=Acta Crystallogr., Sect. F: Struct. Biol. Cryst. Commun.;ACSFCL;M
Acta Hydrochimica et Hydrobiologica=Acta Hydrochim. Hydrobiol.;AHCBAU;BM
Acta Materialia=Acta Mater.;ACMAFD;20/YR
Acta Pharmaceutica (Zagreb, Croatia)=Acta Pharm. (Zagreb, Croatia);ACPHEE;Q
Acta Pharmacologica Sinica=Acta Pharmacol. Sin.;APSCG5;M
Acta Physica Polonica, A=Acta Phys. Pol., A;ATPLB6;M
Acta Physica Polonica, B=Acta Phys. Pol., B;APOBBB;M
Acta Physiologica Scandinavica=Acta Physiol. Scand.;APSCAX;M
Adsorption=Adsorption;ADSOFO;Q
Adsorption Science & Technology=Adsorpt. Sci. Technol.;ASTEEZ;10/YR
Advanced Drug Delivery Reviews=Adv. Drug Delivery Rev.;ADDREP;15/YR
Advanced Functional Materials=Adv. Funct. Mater.;AFMDC6;M
Advanced Materials (Weinheim, Germany)=Adv. Mater. (Weinheim, Ger.);ADVMEW;SM
Advanced Synthesis & Catalysis=Adv. Synth. Catal.;ASCAF7;15/YR
Advances in Applied Ceramics=Adv. Appl. Ceram.;AACDCN;BM
Advances in Atomic, Molecular, and Optical Physics=Adv. At., Mol., Opt. Phys.;AAMPE9;IRR
Advances in Chemical Physics=Adv. Chem. Phys.;ADCPAA;IRR
Advances in Chromatography (New York, NY, United States)=Adv. Chromatogr. (N. Y., NY, U. S.);ADCYA3;IRR
Advances in Colloid and Interface Science=Adv. Colloid Interface Sci.;ACISB9;24/YR
Advances in Electrochemical Science and Engineering=Adv. Electrochem. Sci. Eng.;AESEEY;IRR
Advances in Inorganic Chemistry=Adv. Inorg. Chem.;AICHEP;IRR
Advances in Polymer Science=Adv. Polym. Sci.;APSIDK;IRR
Advances in Polymer Technology=Adv. Polym. Technol.;APTYD5;Q
Advances in Quantum Chemistry=Adv. Quantum Chem.;AQCHA9;IRR
Advances in X-Ray Analysis=Adv. X-Ray Anal.;AXRAAA;A
Aerosol Science and Technology=Aerosol Sci. Technol.;ASTYDQ;M
Afinidad=Afinidad;AFINAE;BM
Aging Cell=Aging Cell;ACGECQ;BM
AIChE Journal=AIChE J.;AICEAC;M
American Ceramic Society Bulletin=Am. Ceram. Soc. Bull.;ACSBA7;M
American Journal of Clinical Nutrition=Am. J. Clin. Nutr.;AJCNAC;M
American Journal of Human Genetics=Am. J. Hum. Genet.;AJHGAG;M
American Journal of Physiology=Am. J. Physiol.;AJPHAP;M
American Journal of Respiratory Cell and Molecular Biology=Am. J. Respir. Cell Mol. Biol.;AJRBEL;M
American Mineralogist=Am. Mineral.;AMMIAY;8/YR
Amino Acids=Amino Acids;AACIE6;8/YR
Analyst (Cambridge, United Kingdom)=Analyst (Cambridge, U. K.);ANALAO;M
Analytica Chimica Acta=Anal. Chim. Acta;ACACAM;52/YR
Analytical and Bioanalytical Chemistry=Anal. Bioanal. Chem.;ABCNBP;SM
Analytical Biochemistry=Anal. Biochem.;ANBCA2;SM
Analytical Chemistry=Anal. Chem.;ANCHAM;SM
Analytical Letters=Anal. Lett.;ANALBP;15/YR
Analytical Sciences=Anal. Sci.;ANSCEN;M
Angewandte Chemie, International Edition=Angew. Chem., Int. Ed.;ACIEF5;W
Animal Welfare=Anim. Welfare;ANWEEF;4/YR
Animal Welfare Information Center Bulletin=Anim. Welfare Inf. Cent. Bull.;AWICAW;Q
Annales de Chimie (Cachan, France)=Ann. Chim. (Cachan, Fr.);ANCPAC;6/YR
Annales Pharmaceutiques Francaises=Ann. Pharm. Fr.;APFRAD;BM
Annali di Chimica (Rome, Italy)=Ann. Chim. (Rome, Italy);ANCRAI;BM
Annals of Nuclear Energy=Ann. Nucl. Energy;ANENDJ;18/YR
Annals of Nutrition & Metabolism=Ann. Nutr. Metab.;ANUMDS;BM
Annals of Physics (San Diego, CA, United States)=Ann. Phys. (San Diego, CA, U. S.);APNYA6;M
Annexins=Annexins;ANNEC2;Q
Annual Reports in Medicinal Chemistry=Annu. Rep. Med. Chem.;ARMCBI;A
Annual Reports on NMR Spectroscopy=Annu. Rep. NMR Spectrosc.;NMRPAJ;IRR
Annual Reports on the Progress of Chemistry, Section A: Inorganic Chemistry=Annu. Rep. Prog. Chem., Sect. A: Inorg. Chem.;APCCDO;A
Annual Reports on the Progress of Chemistry, Section B: Organic Chemistry=Annu. Rep. Prog. Chem., Sect. B: Org. Chem.;CACBB4;A
Annual Reports on the Progress of Chemistry, Section C: Physical Chemistry=Annu. Rep. Prog. Chem., Sect. C: Phys. Chem.;ACPCDW;A
Annual Review of Biochemistry=Annu. Rev. Biochem.;ARBOAW;A
Annual Review of Biomedical Engineering=Annu. Rev. Biomed. Eng.;ARBEF7;A
Annual Review of Biophysics and Biomolecular Structure=Annu. Rev. Biophys. Biomol. Struct.;ABBSE4;A
Annual Review of Cell and Developmental Biology=Annu. Rev. Cell Dev. Biol.;ARDBF8;A
Annual Review of Earth and Planetary Sciences=Annu. Rev. Earth Planet. Sci.;AREPCI;A
Annual Review of Entomology=Annu. Rev. Entomol.;ARENAA;A
Annual Review of Genetics=Annu. Rev. Genet.;ARVGB7;A
Annual Review of Genomics and Human Genetics=Annu. Rev. Genomics Hum. Genet.;ARGHC4;A
Annual Review of Immunology=Annu. Rev. Immunol.;ARIMDU;A
Annual Review of Materials Research=Annu. Rev. Mater. Res.;ARMRCU;A
Annual Review of Medicine=Annu. Rev. Med.;ARMCAH;A
Annual Review of Microbiology=Annu. Rev. Microbiol.;ARMIAZ;A
Annual Review of Neuroscience=Annu. Rev. Neurosci.;ARNSD5;A
Annual Review of Nuclear and Particle Science=Annu. Rev. Nucl. Part. Sci.;ARPSDF;A
Annual Review of Nutrition=Annu. Rev. Nutr.;ARNTD8;A
Annual Review of Pharmacology and Toxicology=Annu. Rev. Pharmacol. Toxicol.;ARPTDI;A
Annual Review of Physical Chemistry=Annu. Rev. Phys. Chem.;ARPLAP;A
Annual Review of Physiology=Annu. Rev. Physiol.;ARPHAD;A
Annual Review of Phytopathology=Annu. Rev. Phytopathol.;APPYAG;A
Annual Review of Plant Biology=Annu. Rev. Plant Biol.;ARPBDW;A
Anti-Cancer Drugs=Anti-Cancer Drugs;ANTDEV;10/YR
Antibiotiki i Khimioterapiya=Antibiot. Khimioter.;ANKHEW;M
Antimicrobial Agents and Chemotherapy=Antimicrob. Agents Chemother.;AMACCQ;M
Antioxidants & Redox Signaling=Antioxid. Redox Signaling;ARSIF2;BM
Antiviral Chemistry & Chemotherapy=Antiviral Chem. Chemother.;ACCHEH;BM
Antiviral Research=Antiviral Res.;ARSRDR;M
Applied and Environmental Microbiology=Appl. Environ. Microbiol.;AEMIDF;M
Applied Biochemistry and Biotechnology=Appl. Biochem. Biotechnol.;ABIBDL;24/YR
Applied Biochemistry and Microbiology=Appl. Biochem. Microbiol.;APBMAC;BM
Applied Catalysis, A: General=Appl. Catal., A;ACAGE4;36/YR
Applied Catalysis, B: Environmental=Appl. Catal., B;ACBEE3;28/YR
Applied Clay Science=Appl. Clay Sci.;ACLSER;BM
Applied Geochemistry=Appl. Geochem.;APPGEY;M
Applied Microbiology and Biotechnology=Appl. Microbiol. Biotechnol.;AMBIDG;18/YR
Applied Organometallic Chemistry=Appl. Organomet. Chem.;AOCHEX;M
Applied Physics A: Materials Science & Processing=Appl. Phys. A: Mater. Sci. Process.;APAMFC;16/YR
Applied Physics B: Lasers and Optics=Appl. Phys. B: Lasers Opt.;APBOEM;16/YR
Applied Physics Letters=Appl. Phys. Lett.;APPLAB;W
Applied Radiation and Isotopes=Appl. Radiat. Isot.;ARISEF;M
Applied Spectroscopy=Appl. Spectrosc.;APSPA4;M
Applied Surface Science=Appl. Surf. Sci.;ASUSEE;19/YR
Aquatic Toxicology=Aquat. Toxicol.;AQTODG;20/YR
Archaea=Archaea;ARCHCI;IRR
Archiv der Pharmazie (Weinheim, Germany)=Arch. Pharm. (Weinheim, Ger.);ARPMAS;M
Archives of Biochemistry and Biophysics=Arch. Biochem. Biophys.;ABBIA4;SM
Archives of Environmental Contamination and Toxicology=Arch. Environ. Contam. Toxicol.;AECTCV;8/YR
Archives of Insect Biochemistry and Physiology=Arch. Insect Biochem. Physiol.;AIBPEA;M
Archives of Microbiology=Arch. Microbiol.;AMICCW;M
Archives of Pharmacal Research=Arch. Pharmacal Res.;APHRDQ;M
Archives of Physiology and Biochemistry=Arch. Physiol. Biochem.;APBIF5;5/YR
Archives of Toxicology=Arch. Toxicol.;ARTODN;12/YR
Archives of Virology=Arch. Virol.;ARVIDF;12/YR
Archivum Combustionis=Arch. Combust.;ACOMEO;Q
ARKIVOC (Gainesville, FL, United States)=ARKIVOC (Gainesville, FL, U. S.);AGFUAR;IRR
Arteriosclerosis, Thrombosis, and Vascular Biology=Arterioscler., Thromb., Vasc. Biol.;ATVBFA;M
Arzneimittel Forschung=Arzneim. Forsch.;ARZNAD;M
Asian Journal of Chemistry=Asian J. Chem.;AJCHEW;Q
Assay and Drug Development Technologies=Assay Drug Dev. Technol.;ADDTAR;BM
Atherosclerosis (Amsterdam, Netherlands)=Atherosclerosis (Amsterdam, Neth.);ATHSBL;M
ATLA, Alternatives to Laboratory Animals=ATLA, Altern. Lab. Anim.;AALADQ;BM
Atmospheric Chemistry and Physics=Atmos. Chem. Phys.;ACPTCE;12/YR
Atmospheric Environment=Atmos. Environ.;AENVEQ;40/YR
Atomic Energy (New York, NY, United States)=At. Energy (N. Y., NY, U. S.);AENYEZ;M
Atomic Spectroscopy=At. Spectrosc.;ASPND7;BM
Australian Journal of Chemistry=Aust. J. Chem.;AJCHAS;M
Autonomic & Autacoid Pharmacology=Auton. Autacoid Pharmacol.;AAPUC3;Q
Azerbaidzhanskii Khimicheskii Zhurnal=Azerb. Khim. Zh.;AZKZAU;Q
Basic & Clinical Pharmacology & Toxicology=Basic Clin. Pharmacol. Toxicol.;BCPTBO;M
Beilstein Journal of Organic Chemistry=Beilstein J. Org. Chem.;BJOCBH;IRR
Biocatalysis and Biotransformation=Biocatal. Biotransform.;BOBOEQ;BM
Biochemical and Biophysical Research Communications=Biochem. Biophys. Res. Commun.;BBRCA9;50/YR
Biochemical Genetics=Biochem. Genet.;BIGEBA;BM
Biochemical Journal=Biochem. J.;BIJOAK;SM
Biochemical Pharmacology=Biochem. Pharmacol.;BCPCA6;SM
Biochemical Society Transactions=Biochem. Soc. Trans.;BCSTB5;6/YR
Biochemical Systematics and Ecology=Biochem. Syst. Ecol.;BSECBU;M
Biochemistry=Biochemistry;BICHAW;W
Biochemistry (Moscow)=Biochemistry (Moscow);BIORAK;M
Biochemistry and Cell Biology=Biochem. Cell Biol.;BCBIEQ;BM
Biochemistry and Molecular Biology Education=Biochem. Mol. Biol. Educ.;BMBECE;BM
Biochimica et Biophysica Acta=Biochim. Biophys. Acta;BBACAQ;
Biochimica et Biophysica Acta, Bioenergetics=Biochim. Biophys. Acta, Bioenerg.;BBBEB4;15/YR
Biochimica et Biophysica Acta, Biomembranes=Biochim. Biophys. Acta, Biomembr.;BBBMBS;20/YR
Biochimica et Biophysica Acta, Biophysics Including Photosynthesis=Biochim. Biophys. Acta, Biophys. Incl. Photosynth.;BBABER;
Biochimica et Biophysica Acta, Enzymology=Biochim. Biophys. Acta, Enzymol.;BBEZAD;
Biochimica et Biophysica Acta, Enzymology and Biological Oxidation=Biochim. Biophys. Acta, Enzymol. Biol. Oxid.;BBAECY;
Biochimica et Biophysica Acta, Gene Structure and Expression=Biochim. Biophys. Acta, Gene Struct. Expression;BBGSD5;18/YR
Biochimica et Biophysica Acta, General Subjects=Biochim. Biophys. Acta, Gen. Subj.;BBGSB3;18/YR
Biochimica et Biophysica Acta, Lipids and Lipid Metabolism=Biochim. Biophys. Acta, Lipids Lipid Metab.;BBLLA6;18/YR
Biochimica et Biophysica Acta, Molecular and Cell Biology of Lipids=Biochim. Biophys. Acta, Mol. Cell Biol. Lipids;BBMLFG;18/YR
Biochimica et Biophysica Acta, Molecular Basis of Disease=Biochim. Biophys. Acta, Mol. Basis Dis.;BBADEX;9/YR
Biochimica et Biophysica Acta, Molecular Cell Research=Biochim. Biophys. Acta, Mol. Cell Res.;BBAMCO;15/YR
Biochimica et Biophysica Acta, Mucoproteins and Mucopolysaccharides=Biochim. Biophys. Acta, Mucoproteins Mucopolysaccharides;BBAMFR;
Biochimica et Biophysica Acta, Protein Structure=Biochim. Biophys. Acta, Protein Struct.;BBPTBH;
Biochimica et Biophysica Acta, Protein Structure and Molecular Enzymology=Biochim. Biophys. Acta, Protein Struct. Mol. Enzymol.;BBAEDZ;16/YR
Biochimica et Biophysica Acta, Proteins and Proteomics=Biochim. Biophys. Acta, Proteins Proteomics;BBAPBW;16/YR
Biochimica et Biophysica Acta, Reviews on Bioenergetics=Biochim. Biophys. Acta, Rev. Bioenerg.;BRBECF;
Biochimica et Biophysica Acta, Reviews on Biomembranes=Biochim. Biophys. Acta, Rev. Biomembr.;BRBMC5;3/YR
Biochimica et Biophysica Acta, Reviews on Cancer=Biochim. Biophys. Acta, Rev. Cancer;BBACEU;4/YR
Biochimica et Biophysica Acta, Specialized Section on Biophysical Subjects=Biochim. Biophys. Acta, Spec. Sect. Biophys. Subj.;BBASEA;
Biochimica et Biophysica Acta, Specialized Section on Enzymological Subjects=Biochim. Biophys. Acta, Spec. Sect. Enzymol. Subj.;BBASD9;
Biochimica et Biophysica Acta, Specialized Section on Lipids and Related Subjects=Biochim. Biophys. Acta, Spec. Sect. Lipids Relat. Subj.;BBASC8;
Mucopolysaccharides Biochimica et Biophysica Acta, Specialized Section on Mucoproteins and Mucopolysaccharides=Biochim. Biophys. Acta, Spec. Sect. Mucoproteins;BBASFB;
Subj. Biochimica et Biophysica Acta, Specialized Section on Nucleic Acids and Related Subjects=Biochim. Biophys. Acta, Spec. Sect. Nucleic Acids Relat.;BBASB7;
Biochimie=Biochimie;BICMBE;M
Bioconjugate Chemistry=Bioconjugate Chem.;BCCHES;BM
Bioelectrochemistry=Bioelectrochemistry;BIOEFK;6/YR
BioFactors=BioFactors;BIFAEU;12/YR
Biofizika=Biofizika;BIOFAI;BM
Biogenic Amines=Biog. Amines;BIAME7;6/YR
Bioinformatics=Bioinformatics;BOINFP;24/YR
Bioinorganic Chemistry and Applications=Bioinorg. Chem. Appl.;BCAIAH;4/YR
Biological & Pharmaceutical Bulletin=Biol. Pharm. Bull.;BPBLEO;M
Biological Chemistry=Biol. Chem.;BICHF3;M
Biological Trace Element Research=Biol. Trace Elem. Res.;BTERDG;18/YR
Biologicheskie Membrany=Biol. Membr.;BIMEE9;BM
Biology of Reproduction=Biol. Reprod.;BIREBV;13/YR
Biomacromolecules=Biomacromolecules;BOMAF6;BM
Biomarkers=Biomarkers;BIOMFA;BM
Biomaterials=Biomaterials;BIMADU;36/YR
Biomedical Chromatography=Biomed. Chromatogr.;BICHE2;8/YR
Biomedical Research=Biomed. Res.;BRESD5;BM
Biomeditsinskaya Khimiya=Biomed. Khim.;BKIHA8;BM
BioMetals=BioMetals;BOMEEH;BM
Biomolecular Engineering=Biomol. Eng.;BIENFV;6/YR
Bioorganic & Medicinal Chemistry=Bioorg. Med. Chem.;BMECEP;SM
Bioorganic & Medicinal Chemistry Letters=Bioorg. Med. Chem. Lett.;BMCLE8;SM
Bioorganic Chemistry=Bioorg. Chem.;BOCMBM;BM
Biopharmaceutics & Drug Disposition=Biopharm. Drug Dispos.;BDDID8;9/YR
Biophysical Chemistry=Biophys. Chem.;BICIAZ;21/YR
Biophysical Journal=Biophys. J.;BIOJAU;M
Biopolymers=Biopolymers;BIPMAA;24/YR
Bioprocess and Biosystems Engineering=Bioprocess Biosyst. Eng.;BBEIBV;6/YR
Bioresource Technology=Bioresour. Technol.;BIRTEB;18/YR
Bioscience Reports=Biosci. Rep.;BRPTDT;BM
Bioscience, Biotechnology, and Biochemistry=Biosci., Biotechnol., Biochem.;BBBIEJ;M
Biosensors & Bioelectronics=Biosens. Bioelectron.;BBIOE4;M
BioTechniques=BioTechniques;BTNQDO;M
Biotechnology and Applied Biochemistry=Biotechnol. Appl. Biochem.;BABIEC;BM
Biotechnology and Bioengineering=Biotechnol. Bioeng.;BIBIAU;28/YR
Biotechnology and Bioprocess Engineering=Biotechnol. Bioprocess Eng.;BBEIAU;BM
Biotechnology Letters=Biotechnol. Lett.;BILED3;SM
Biotechnology Progress=Biotechnol. Prog.;BIPRET;BM
Birth Defects Research, Part A: Clinical and Molecular Teratology=Birth Defects Res., Part A;BDRPBT;M
Birth Defects Research, Part B: Developmental and Reproductive Toxicology=Birth Defects Res., Part B;BDRPCU;BM
Birth Defects Research, Part C: Embryo Today--Reviews=Birth Defects Res., Part C;BDRPDV;Q
Bitamin=Bitamin;BTMNA7;M
Blood=Blood;BLOOAW;25/YR
Bopuxue Zazhi=Bopuxue Zazhi;BOZAE2;Q
Brain Research=Brain Res.;BRREAP;72/YR
British Journal of Nutrition=Br. J. Nutr.;BJNUAV;M
British Journal of Pharmacology=Br. J. Pharmacol.;BJPCBM;SM
Bulgarian Chemical Communications=Bulg. Chem. Commun.;BCHCE4;Q
Bulletin of Electrochemistry=Bull. Electrochem.;BUELE6;M
Bulletin of Environmental Contamination and Toxicology=Bull. Environ. Contam. Toxicol.;BECTA6;M
Bulletin of Materials Science=Bull. Mater. Sci.;BUMSDW;BM
Bulletin of the Chemical Society of Japan=Bull. Chem. Soc. Jpn.;BCSJA8;M
Bulletin of the Korean Chemical Society=Bull. Korean Chem. Soc.;BKCSDE;M
Bunseki Kagaku=Bunseki Kagaku;BNSKAK;M
Cailiao Rechuli Xuebao=Cailiao Rechuli Xuebao;CRXAAK;BM
Calcified Tissue International=Calcif. Tissue Int.;CTINDZ;M
CALPHAD: Computer Coupling of Phase Diagrams and Thermochemistry=CALPHAD: Comput. Coupling Phase Diagrams Thermochem.;CCCTD6;Q
Canadian Journal of Analytical Sciences and Spectroscopy=Can. J. Anal. Sci. Spectrosc.;CJASFA;BM
Canadian Journal of Chemical Engineering=Can. J. Chem. Eng.;CJCEA7;BM
Canadian Journal of Chemistry=Can. J. Chem.;CJCHAG;M
Canadian Journal of Microbiology=Can. J. Microbiol.;CJMIAZ;M
Canadian Journal of Physics=Can. J. Phys.;CJPHAD;M
Canadian Journal of Physiology and Pharmacology=Can. J. Physiol. Pharmacol.;CJPPA3;M
Canadian Metallurgical Quarterly=Can. Metall. Q.;CAMQAU;Q
Canadian Mineralogist=Can. Mineral.;CAMIA6;BM
Cancer Cell=Cancer Cell;CCAECI;M
Cancer Gene Therapy=Cancer Gene Ther.;CGTHEG;M
Cancer Genomics & Proteomics=Cancer Genomics Proteomics;CGPAC7;BM
Cancer Letters (Amsterdam, Netherlands)=Cancer Lett. (Amsterdam, Neth.);CALEDQ;28/YR
Cancer Research=Cancer Res.;CNREA8;SM
Cancer Science=Cancer Sci.;CSACCM;M
Carbohydrate Polymers=Carbohydr. Polym.;CAPOD8;16/YR
Carbohydrate Research=Carbohydr. Res.;CRBRAT;18/YR
Carbon=Carbon;CRBNAH;15/YR
Carcinogenesis=Carcinogenesis;CRNGDP;M
Cardiovascular Research=Cardiovasc. Res.;CVREAU;14/YR
Catalysis Communications=Catal. Commun.;CCAOAC;M
Catalysis Letters=Catal. Lett.;CALEER;28/YR
Catalysis Reviews - Science and Engineering=Catal. Rev. - Sci. Eng.;CRSEC9;Q
Catalysis Today=Catal. Today;CATTEA;44/YR
Cell (Cambridge, MA, United States)=Cell (Cambridge, MA, U. S.);CELLB5;BW
Cell Biochemistry and Biophysics=Cell Biochem. Biophys.;CBBIFV;6/YR
Cell Biochemistry and Function=Cell Biochem. Funct.;CBFUDH;6/YR
Cell Calcium=Cell Calcium;CECADV;M
Cell Cycle=Cell Cycle;CCEYAS;M
Cell Metabolism=Cell Metab.;CMEEB5;M
Cellular and Molecular Biology (Paris, France, Online)=Cell. Mol. Biol. (Paris, Fr., Online);CMBPBN;IRR
Cellular and Molecular Biology (Sarreguemines, France, Print)=Cell. Mol. Biol. (Sarreguemines, Fr., Print);CMOBEF;8/YR
Cellular and Molecular Life Sciences=Cell. Mol. Life Sci.;CMLSFI;24/YR
Cellular Immunology=Cell. Immunol.;CLIMB8;M
Cellular Microbiology=Cell. Microbiol.;CEMIF5;M
Cellular Physiology and Biochemistry=Cell. Physiol. Biochem.;CEPBEW;6/YR
Cellular Polymers=Cell. Polym.;CELPDJ;BM
Cellulose Chemistry and Technology=Cellul. Chem. Technol.;CECTAH;BM
Cement & Concrete Composites=Cem. Concr. Compos.;CCOCEG;10/YR
Cement and Concrete Research=Cem. Concr. Res.;CCNRAI;M
Ceramics International=Ceram. Int.;CINNDH;8/YR
Ceramics-Silikaty=Ceram.-Silik.;CERSEP;Q
Cereal Chemistry=Cereal Chem.;CECHAF;BM
Ceska a Slovenska Farmacie=Ceska Slov. Farm.;CSLFEK;BM
ChemBioChem=ChemBioChem;CBCHFX;M
Chemia Analityczna (Warsaw, Poland)=Chem. Anal. (Warsaw, Pol.);CANWAJ;BM
Chemical & Pharmaceutical Bulletin=Chem. Pharm. Bull.;CPBTAL;M
Chemical and Biochemical Engineering Quarterly=Chem. Biochem. Eng. Q.;CBEQEZ;Q
Chemical Communications (Cambridge, United Kingdom)=Chem. Commun. (Cambridge, U. K.);CHCOFS;48/YR
Chemical Engineering & Technology=Chem. Eng. Technol.;CETEER;M
Chemical Engineering and Processing=Chem. Eng. Process.;CENPEU;M
Chemical Engineering Communications=Chem. Eng. Commun.;CEGCAK;M
Chemical Engineering Journal (Amsterdam, Netherlands)=Chem. Eng. J. (Amsterdam, Neth.);CMEJAJ;27/YR
Chemical Engineering Progress=Chem. Eng. Prog.;CEPRA8;M
Chemical Engineering Research and Design=Chem. Eng. Res. Des.;CERDEE;M
Chemical Engineering Science=Chem. Eng. Sci.;CESCAC;SM
Chemical Geology=Chem. Geol.;CHGEAD;44/YR
Chemical Papers=Chem. Pap.;CHPAEG;6/YR
Chemical Physics=Chem. Phys.;CMPHC2;33/YR
Chemical Physics Letters=Chem. Phys. Lett.;CHPLBC;W
Chemical Record=Chem. Rec.;CRHEAK;BM
Chemical Research in Chinese Universities=Chem. Res. Chin. Univ.;CRCUED;BM
Chemical Research in Toxicology=Chem. Res. Toxicol.;CRTOEC;M
Chemical Reviews (Washington, DC, United States)=Chem. Rev. (Washington, DC, U. S.);CHREAY;M
Chemical Society Reviews=Chem. Soc. Rev.;CSRVBR;12/YR
Chemical Speciation and Bioavailability=Chem. Speciation Bioavailability;CHSBEY;Q
Chemical Vapor Deposition=Chem. Vap. Deposition;CVDEFX;M
Chemicke Listy=Chem. Listy;CHLSAC;M
Chemico-Biological Interactions=Chem.-Biol. Interact.;CBINA8;18/YR
Chemie der Erde=Chem. Erde;CERDAA;4/YR
Chemie Ingenieur Technik=Chem. Ing. Tech.;CITEAH;M
Chemija=Chemija;CHMJES;4/YR
Chemistry & Biodiversity=Chem. Biodiversity;CBHIAM;M
Chemistry & Biology (Cambridge, MA, United States)=Chem. Biol. (Cambridge, MA, U. S.);CBOLE2;M
Chemistry & Industry (London, United Kingdom)=Chem. Ind. (London, U. K.);CHINAG;SM
Chemistry and Physics of Lipids=Chem. Phys. Lipids;CPLIA4;M
Chemistry and Technology of Fuels and Oils=Chem. Technol. Fuels Oils;CTFOAK;BM
Chemistry Letters=Chem. Lett.;CMLTAG;M
Chemistry of Heterocyclic Compounds (New York, NY, United States)=Chem. Heterocycl. Compd. (N. Y., NY, U. S.);CHCCAL;M
Chemistry of Materials=Chem. Mater.;CMATEX;BW
Chemistry of Natural Compounds=Chem. Nat. Compd.;CHNCA8;BM
Chemistry--A European Journal=Chem.--Eur. J.;CEUJED;SM
Chemometrics and Intelligent Laboratory Systems=Chemom. Intell. Lab. Syst.;CILSEN;9/YR
Chemosphere=Chemosphere;CMSHAF;44/YR
Chemotherapy (Basel, Switzerland)=Chemotherapy (Basel, Switz.);CHTHBK;BM
ChemPhysChem=ChemPhysChem;CPCHFT;12/YR
Chemtracts=Chemtracts;CHEMFW;12/YR
Chimia=Chimia;CHIMAD;M
Chimica e l'Industria (Milan, Italy)=Chim. Ind. (Milan, Italy);CINMAB;10/YR
Chinese Chemical Letters=Chin. Chem. Lett.;CCLEE7;M
Chinese Journal of Chemical Engineering=Chin. J. Chem. Eng.;CJCEEB;BM
Chinese Journal of Chemistry=Chin. J. Chem.;CJOCEV;M
Chinese Journal of Geochemistry=Chin. J. Geochem.;CJGEEV;Q
Chinese Journal of Polymer Science=Chin. J. Polym. Sci.;CJPSEG;BM
Chirality=Chirality;CHRLEP;10/YR
Chromatographia=Chromatographia;CHRGB7;M
Chromosome Research=Chromosome Res.;CRRSEE;8/YR
Circulation Research=Circ. Res.;CIRUAL;SM
Clay Minerals=Clay Miner.;CLMIAF;Q
Clays and Clay Minerals=Clays Clay Miner.;CLCMAB;BM
Clinica Chimica Acta=Clin. Chim. Acta;CCATAR;M
Clinical and Diagnostic Laboratory Immunology=Clin. Diagn. Lab. Immunol.;CDIMEN;M
Clinical and Experimental Pharmacology and Physiology=Clin. Exp. Pharmacol. Physiol.;CEXPB9;M
Clinical Chemistry (Washington, DC, United States)=Clin. Chem. (Washington, DC, U. S.);CLCHAU;M
Clinical Chemistry and Laboratory Medicine=Clin. Chem. Lab. Med.;CCLMFW;M
Clinical Immunology (San Diego, CA, United States)=Clin. Immunol. (San Diego, CA, U. S.);CLIIFY;M
Clinical Proteomics=Clin. Proteomics;CPLRCX;4/YR
Cloning and Stem Cells=Cloning Stem Cells;CSCLBO;Q
Coal Preparation (Philadelphia, PA, United States)=Coal Prep. (Philadelphia, PA, U. S.);COAPDY;6/YR
Collection of Czechoslovak Chemical Communications=Collect. Czech. Chem. Commun.;CCCCAK;M
Colloid and Polymer Science=Colloid Polym. Sci.;CPMSB6;M
Colloid Journal=Colloid J.;CJRSEQ;BM
Colloids and Surfaces, A: Physicochemical and Engineering Aspects=Colloids Surf., A;CPEAEH;24/YR
Colloids and Surfaces, B: Biointerfaces=Colloids Surf., B;CSBBEQ;28/YR
Coloration Technology=Color. Technol.;CTOEAZ;BM
Combinatorial Chemistry and High Throughput Screening=Comb. Chem. High Throughput Screening;CCHSFU;8/YR
Combustion and Flame=Combust. Flame;CBFMAO;M
Combustion Science and Technology=Combust. Sci. Technol.;CBSTB9;M
Comments on Inorganic Chemistry=Comments Inorg. Chem.;COICDZ;BM
Communications in Soil Science and Plant Analysis=Commun. Soil Sci. Plant Anal.;CSOSA2;20/YR
Comparative and Functional Genomics=Comp. Funct. Genomics;CFGOAT;8/YR
Comparative Biochemistry and Physiology, Part A: Molecular & Integrative Physiology=Comp. Biochem. Physiol., Part A: Mol. Integr. Physiol.;CBPAB5;M
Comparative Biochemistry and Physiology, Part B: Biochemistry & Molecular Biology=Comp. Biochem. Physiol., Part B: Biochem. Mol. Biol.;CBPBB8;M
Comparative Biochemistry and Physiology, Part C: Toxicology & Pharmacology=Comp. Biochem. Physiol., Part C: Toxicol. Pharmacol.;CBPPFK;M
Comparative Medicine=Comp. Med.;COMEFT;BM
Comptes Rendus Chimie=C. R. Chim.;CRCOCR;M
Comptes Rendus Physique=C. R. Phys.;CRPOBN;10/YR
Computational Biology and Chemistry=Comput. Biol. Chem.;CBCOCH;BM
Computer Physics Communications=Comput. Phys. Commun.;CPHCBZ;SM
Computers & Chemical Engineering=Comput. Chem. Eng.;CCENDW;M
Comunicaciones presentadas a las Jornadas del Comite Espanol de la Detergencia=Comun. Jorn. Com. Esp. Deterg.;CJCDD7;A
Contemporary Topics in Laboratory Animal Science=Contemp. Top. Lab. Anim. Sci.;CTLAA8;BM
Contributions to Mineralogy and Petrology=Contrib. Mineral. Petrol.;CMPEAP;M
Coordination Chemistry Reviews=Coord. Chem. Rev.;CCHRAM;M
Corrosion (Houston, TX, United States)=Corrosion (Houston, TX, U. S.);CORRAK;M
Corrosion Engineering, Science and Technology=Corros. Eng., Sci. Technol.;CESTBU;Q
Corrosion Reviews=Corros. Rev.;CORVE2;Q
Corrosion Science=Corros. Sci.;CRRSAA;M
Critical Reviews in Analytical Chemistry=Crit. Rev. Anal. Chem.;CCACBB;Q
Critical Reviews in Solid State and Materials Sciences=Crit. Rev. Solid State Mater. Sci.;CCRSDA;Q
Croatica Chemica Acta=Croat. Chem. Acta;CCACAA;Q
Cryogenics=Cryogenics;CRYOAX;M
Crystal Growth & Design=Cryst. Growth Des.;CGDEFU;BM
Crystal Research and Technology=Cryst. Res. Technol.;CRTEDF;12/YR
Crystallography Reports=Crystallogr. Rep.;CYSTE3;BM
CrystEngComm=CrystEngComm;CRECF4;IRR
Cuihua Xuebao=Cuihua Xuebao;THHPD3;M
Current Alzheimer Research=Curr. Alzheimer Res.;CARUBY;5/YR
Current Analytical Chemistry=Curr. Anal. Chem.;CACUBR;3/YR
Current Biology=Curr. Biol.;CUBLE2;SM
Current Cancer Drug Targets=Curr. Cancer Drug Targets;CCDTB9;8/YR
Current Computer-Aided Drug Design=Curr. Comput.-Aided Drug Des.;CCDDAS;4/YR
Current Drug Delivery=Curr. Drug Delivery;CDDUBJ;4/YR
Current Drug Discovery Technologies=Curr. Drug Discovery Technol.;CDDTAF;4/YR
Current Drug Metabolism=Curr. Drug Metab.;CDMUBU;BM
Current Drug Targets=Curr. Drug Targets;CDTUAU;8/YR
Current Drug Targets: Cardiovascular & Haematological Disorders=Curr. Drug Targets: Cardiovasc. & Haematol. Disord.;CDTCBB;6/YR
Current Drug Targets: CNS & Neurological Disorders=Curr. Drug Targets: CNS Neurol. Disord.;CDTCCC;6/YR
Current Drug Targets: Immune, Endocrine and Metabolic Disorders=Curr. Drug Targets: Immune, Endocr. Metab. Disord.;CDTIBT;4/YR
Current Drug Targets: Infectious Disorders=Curr. Drug Targets: Infect. Disord.;CDTIAS;Q
Current Drug Targets: Inflammation & Allergy=Curr. Drug Targets: Inflammation Allergy;CDTICU;BM
Current Enzyme Inhibition=Curr. Enzyme Inhib.;CEIUAG;3/YR
Current Gene Therapy=Curr. Gene Ther.;CGTUAH;6/YR
Current Genetics=Curr. Genet.;CUGED5;M
Current Genomics=Curr. Genomics;CGUEA8;8/YR
Current HIV Research=Curr. HIV Res.;CHRUBF;4/YR
Current Immunology Reviews=Curr. Immunol. Rev.;CIRUBM;3/YR
Current Medicinal Chemistry=Curr. Med. Chem.;CMCHE7;26/YR
Current Medicinal Chemistry: Anti-Cancer Agents=Curr. Med. Chem.: Anti-Cancer Agents;CMCACI;BM
Current Medicinal Chemistry: Anti-Infective Agents=Curr. Med. Chem.: Anti-Infect. Agents;CMCAFL;4/YR
Current Medicinal Chemistry: Anti-Inflammatory & Anti-Allergy Agents=Curr. Med. Chem.: Anti-Inflammatory Anti-Allergy Agents;CMCAGM;6/YR
Current Medicinal Chemistry: Cardiovascular & Hematological Agents=Curr. Med. Chem.: Cardiovasc. Hematol. Agents;CMCCDP;4/YR
Current Medicinal Chemistry: Central Nervous System Agents=Curr. Med. Chem.: Cent. Nerv. Syst. Agents;CMCCCO;Q
Current Medicinal Chemistry: Immunology, Endocrine & Metabolic Agents=Curr. Med. Chem.: Immunol., Endocr. Metab. Agents;CMCIC8;6/YR
Current Microbiology=Curr. Microbiol.;CUMIDD;M
Current Molecular Medicine=Curr. Mol. Med.;CMMUBP;8/yr
Current Neuropharmacology=Curr. Neuropharmacol.;CNUEAN;Q
Current Opinion in Biotechnology=Curr. Opin. Biotechnol.;CUOBE3;BM
Current Opinion in Cell Biology=Curr. Opin. Cell Biol.;COCBE3;BM
Current Opinion in Chemical Biology=Curr. Opin. Chem. Biol.;COCBF4;BM
Current Opinion in Colloid & Interface Science=Curr. Opin. Colloid Interface Sci.;COCSFL;BM
Current Opinion in Drug Discovery & Development=Curr. Opin. Drug Discovery Dev.;CODDFF;BM
Current Opinion in Genetics & Development=Curr. Opin. Genet. Dev.;COGDET;BM
Current Opinion in Immunology=Curr. Opin. Immunol.;COPIEL;BM
Current Opinion in Lipidology=Curr. Opin. Lipidol.;COPLEU;BM
Current Opinion in Neurobiology=Curr. Opin. Neurobiol.;COPUEN;BM
Current Opinion in Pharmacology=Curr. Opin. Pharmacol.;COPUBK;BM
Current Opinion in Structural Biology=Curr. Opin. Struct. Biol.;COSBEF;BM
Current Organic Chemistry=Curr. Org. Chem.;CORCFE;18/YR
Current Organic Synthesis=Curr. Org. Synth.;COSUC2;4/YR
Current Pharmaceutical Analysis=Curr. Pharm. Anal.;CPAUBK;3/YR
Current Pharmaceutical Biotechnology=Curr. Pharm. Biotechnol.;CPBUBP;BM
Current Pharmaceutical Design=Curr. Pharm. Des.;CPDEFP;32/YR
Current Pharmacogenomics=Curr. Pharmacogenomics;CPUHAC;Q
Current Protein and Peptide Science=Curr. Protein Pept. Sci.;CPPSCM;BM
Current Proteomics=Curr. Proteomics;CPURCA;4/YR
Current Separations=Curr. Sep.;CUSEEW;IRR
Current Topics in Medicinal Chemistry (Sharjah, United Arab Emirates)=Curr. Top. Med. Chem. (Sharjah, United Arab Emirates);CTMCCL;16/YR
Current Vascular Pharmacology=Curr. Vasc. Pharmacol.;CVPUAY;4/YR
Cytokine & Growth Factor Reviews=Cytokine Growth Factor Rev.;CGFRFB;BM
Cytokine+=Cytokine+;CYTIE9;24/YR
Dalton Transactions=Dalton Trans.;DTARAF;24/YR
Desalination=Desalination;DSLNAH;36/YR
Designed Monomers and Polymers=Des. Monomers Polym.;DMPOF3;6/YR
Development (Cambridge, United Kingdom)=Development (Cambridge, U. K.);DEVPED;SM
Developmental Biology (San Diego, CA, United States)=Dev. Biol. (San Diego, CA, U. S.);DEBIAO;SM
Developmental Brain Research=Dev. Brain Res.;DBRRDB;14/YR
Developmental Cell=Dev. Cell;DCEEBE;M
Developmental Neuroscience (Basel, Switzerland)=Dev. Neurosci. (Basel, Switz.);DENED7;BM
Developments in Biologicals (Basel, Switzerland)=Dev. Biol. (Basel, Switz.);DBEIAI;IRR
Diabetes=Diabetes;DIAEAZ;M
Diamond and Related Materials=Diamond Relat. Mater.;DRMTE3;M
Dianhuaxue=Dianhuaxue;DIANFX;Q
Differentiation (Malden, MA, United States)=Differentiation (Malden, MA, U. S.);DFFNAW;10/YR
Diffusion and Defect Data--Solid State Data, Pt. A: Defect and Diffusion Forum=Diffus. Defect Data, Pt. A;DDAFE7;12/YR
Diffusion and Defect Data--Solid State Data, Pt. B: Solid State Phenomena=Diffus. Defect Data, Pt. B;DDBPE8;6/YR
Diqiu Huaxue=Diqiu Huaxue;TCHHCB;BM
DNA and Cell Biology=DNA Cell Biol.;DCEBE8;M
DNA Repair=DNA Repair;DRNEAR;M
DNA Research=DNA Res.;DARSE8;6/YR
DNA Sequence=DNA Sequence;DNSEES;BM
Doklady Biochemistry and Biophysics=Dokl. Biochem. Biophys.;DBBOAL;BM
Doklady Chemistry=Dokl. Chem.;DKCHAY;M
Doklady Earth Sciences=Dokl. Earth Sci.;DESOAP;9/YR
Doklady Physical Chemistry=Dokl. Phys. Chem.;DKPCAG;M
Doklady Physics=Dokl. Phys.;DOPHFU;M
Dopovidi Natsional'noi Akademii Nauk Ukraini=Dopov. Nats. Akad. Nauk Ukr.;DNAUFL;M
Drug and Chemical Toxicology (1977)=Drug Chem. Toxicol. (1977);DCTODJ;Q
Drug Delivery=Drug Delivery;DDELEB;BM
Drug Development and Industrial Pharmacy=Drug Dev. Ind. Pharm.;DDIPD8;10/YR
Drug Development Research=Drug Dev. Res.;DDREDK;M
Drug Metabolism and Disposition=Drug Metab. Dispos.;DMDSAI;M
Drug Metabolism and Drug Interactions=Drug Metab. Drug Interact.;DMDIEQ;Q
Drug Metabolism and Pharmacokinetics=Drug Metab. Pharmacokinet.;DMPRB8;BM
Dyes and Pigments=Dyes Pigm.;DYPIDX;M
Earth and Planetary Science Letters=Earth Planet. Sci. Lett.;EPSLA2;48/YR
Economic Geology=Econ. Geol.;EGCEA8;8/YR
Ecotoxicology and Environmental Safety=Ecotoxicol. Environ. Saf.;EESADV;9/YR
Ekotekhnologii i Resursosberezhenie=Ekotekhnol. Resursosberezhenie;ERKTE4;BM
Eksperimental'naya i Klinicheskaya Farmakologiya=Eksp. Klin. Farmakol.;EKFAE9;BM
Electroanalysis=Electroanalysis;ELANEU;24/YR
Electrochemical and Solid-State Letters=Electrochem. Solid-State Lett.;ESLEF6;M
Electrochemical Society Interface=Electrochem. Soc. Interface;ELSIE3;Q
Electrochemistry (Tokyo, Japan)=Electrochemistry (Tokyo, Jpn.);EECTFA;M
Electrochemistry Communications=Electrochem. Commun.;ECCMF9;M
Electrochimica Acta=Electrochim. Acta;ELCAAV;SM
Electrophoresis=Electrophoresis;ELCTDN;24/YR
EMBO Journal=EMBO J.;EMJODG;SM
EMBO Reports=EMBO Rep.;ERMEAX;M
Endocrine=Endocrine;EOCRE5;9/YR
Endocrinology=Endocrinology;ENDOAO;M
Energy & Fuels=Energy Fuels;ENFUEM;BM
Engineering in Life Sciences=Eng. Life Sci.;ELSNAE;BM
Environment Protection Engineering=Environ. Prot. Eng.;EPEND9;Q
Environmental and Molecular Mutagenesis=Environ. Mol. Mutagen.;EMMUEG;9/YR
Environmental Chemistry=Environ. Chem.;ECNHAA;4/YR
Environmental Chemistry Letters=Environ. Chem. Lett.;ECLNBJ;4/YR
Environmental Engineering Science=Environ. Eng. Sci.;EESCF5;BM
Environmental Geochemistry and Health=Environ. Geochem. Health;EGHEE3;BM
Environmental Pollution (Amsterdam, Netherlands)=Environ. Pollut. (Amsterdam, Neth.);ENPOEK;18/YR
Environmental Progress=Environ. Prog.;ENVPDI;4/YR
Environmental Research=Environ. Res.;ENVRAL;9/YR
Environmental Science and Technology=Environ. Sci. Technol.;ESTHAG;SM
Environmental Technology=Environ. Technol.;ENVTEV;M
Environmental Toxicology=Environ. Toxicol.;ETOXFH;BM
Environmental Toxicology and Chemistry=Environ. Toxicol. Chem.;ETOCDK;M
Environmental Toxicology and Pharmacology=Environ. Toxicol. Pharmacol.;ETOPFR;6/YR
Enzyme and Microbial Technology=Enzyme Microb. Technol.;EMTED2;M
Erdoel, Erdgas, Kohle=Erdoel, Erdgas, Kohle;EEKOEY;M
Eukaryotic Cell=Eukaryotic Cell;ECUEA2;M
European Cytokine Network=Eur. Cytokine Network;ECYNEJ;4/YR
European Food Research and Technology=Eur. Food Res. Technol.;EFRTFO;M
European Journal of Cell Biology=Eur. J. Cell Biol.;EJCBDN;M
European Journal of Drug Metabolism and Pharmacokinetics=Eur. J. Drug Metab. Pharmacokinet.;EJDPD2;Q
European Journal of Endocrinology=Eur. J. Endocrinol.;EJOEEP;M
European Journal of Immunology=Eur. J. Immunol.;EJIMAF;M
European Journal of Inorganic Chemistry=Eur. J. Inorg. Chem.;EJICFO;SM
European Journal of Lipid Science and Technology=Eur. J. Lipid Sci. Technol.;EJLTFM;M
European Journal of Mass Spectrometry=Eur. J. Mass Spectrom.;EJMSCL;6/YR
European Journal of Medicinal Chemistry=Eur. J. Med. Chem.;EJMCA5;M
European Journal of Mineralogy=Eur. J. Mineral.;EJMIER;BM
European Journal of Organic Chemistry=Eur. J. Org. Chem.;EJOCFK;SM
European Journal of Pharmaceutical Sciences=Eur. J. Pharm. Sci.;EPSCED;15/YR
European Journal of Pharmacology=Eur. J. Pharmacol.;EJPHAZ;72/YR
European Neuropsychopharmacology=Eur. Neuropsychopharmacol.;EURNE8;BM
European Physical Journal A: Hadrons and Nuclei=Eur. Phys. J. A;EPJAFV;M
European Physical Journal B: Condensed Matter Physics=Eur. Phys. J. B;EPJBFY;SM
European Physical Journal C: Particles and Fields=Eur. Phys. J. C;EPCFFB;16/YR
European Physical Journal D: Atomic, Molecular and Optical Physics=Eur. Phys. J. D;EPJDF6;M
European Physical Journal E: Soft Matter=Eur. Phys. J. E;EPJSFH;M
European Polymer Journal=Eur. Polym. J.;EUPJAG;M
Europhysics Letters=Europhys. Lett.;EULEEJ;SM
Experimental and Clinical Endocrinology & Diabetes=Exp. Clin. Endocrinol. Diabetes;ECEDFQ;10/YR
Experimental and Molecular Medicine=Exp. Mol. Med.;EMMEF3;BM
Experimental and Molecular Pathology=Exp. Mol. Pathol.;EXMPA6;BM
Experimental Animals=Exp. Anim.;JIDOAA;Q
Experimental Biology and Medicine (Maywood, NJ, United States)=Exp. Biol. Med. (Maywood, NJ, U. S.);EBMMBE;11/YR
Experimental Cell Research=Exp. Cell Res.;ECREAL;20/YR
Experimental Eye Research=Exp. Eye Res.;EXERA6;M
Expert Opinion on Investigational Drugs=Expert Opin. Invest. Drugs;EOIDER;M
Expert Opinion on Therapeutic Patents=Expert Opin. Ther. Pat.;EOTPEG;M
Faraday Discussions=Faraday Discuss.;FDISE6;3/YR
Farmaco=Farmaco;FRMCE8;M
FASEB Journal=FASEB J.;FAJOEC;15/YR
FEBS Journal=FEBS J.;FJEOAC;SM
FEBS Letters=FEBS Lett.;FEBLAL;BW
FEMS Immunology and Medical Microbiology=FEMS Immunol. Med. Microbiol.;FIMIEV;9/YR
FEMS Microbiology Ecology=FEMS Microbiol. Ecol.;FMECEZ;M
FEMS Microbiology Letters=FEMS Microbiol. Lett.;FMLED7;SM
FEMS Microbiology Reviews=FEMS Microbiol. Rev.;FMREE4;5/YR
FEMS Yeast Research=FEMS Yeast Res.;FYREAG;M
Fenxi Huaxue=Fenxi Huaxue;FHHHDT;M
Fenzi Cuihua=Fenzi Cuihua;FECUEN;BM
Ferroelectrics=Ferroelectrics;FEROA8;16/YR
Ferroelectrics, Letters Section=Ferroelectr., Lett. Sect.;FELEDJ;BM
Fibre Chemistry=Fibre Chem.;FICYAP;BM
Fire and Materials=Fire Mater.;FMATDV;BM
Fish Physiology and Biochemistry=Fish Physiol. Biochem.;FPBIEP;4/YR
Fisheries Science (Carlton, Australia)=Fish. Sci. (Carlton, Aust.);FSCIEH;BM
Fizika Goreniya i Vzryva=Fiz. Goreniya Vzryva;FGVZA7;BM
Fizika i Khimiya Obrabotki Materialov=Fiz. Khim. Obrab. Mater.;FKOMAT;BM
Fizika Metallov i Metallovedenie=Fiz. Met. Metalloved.;FMMTAK;M
Fluid Phase Equilibria=Fluid Phase Equilib.;FPEQDT;15/YR
Folia Microbiologica (Prague, Czech Republic)=Folia Microbiol. (Prague, Czech Repub.);FOMIAZ;BM
Food Additives & Contaminants=Food Addit. Contam.;FACOEB;M
Food and Chemical Toxicology=Food Chem. Toxicol.;FCTOD7;M
Food Chemistry=Food Chem.;FOCHDJ;20/YR
Food Hydrocolloids=Food Hydrocolloids;FOHYES;BM
Free Radical Biology & Medicine=Free Radical Biol. Med.;FRBMEH;24/YR
Free Radical Research=Free Radical Res.;FRARER;M
Fresenius Environmental Bulletin=Fresenius Environ. Bull.;FENBEL;M
Fuel=Fuel;FUELAC;15/YR
Fuel Cells (Weinheim, Germany)=Fuel Cells (Weinheim, Ger.);FUCEFK;4/YR
Fuel Processing Technology=Fuel Process. Technol.;FPTEDY;15/YR
Fullerenes, Nanotubes, and Carbon Nanostructures=Fullerenes, Nanotubes, Carbon Nanostruct.;FNCNAR;Q
Functional & Integrative Genomics=Funct. Integr. Genomics;FIGUBY;Q
Fundamental & Clinical Pharmacology=Fundam. Clin. Pharmacol.;FCPHEZ;BM
Funtai oyobi Funmatsu Yakin=Funtai oyobi Funmatsu Yakin;FOFUA2;M
Fusion Engineering and Design=Fusion Eng. Des.;FEDEEE;24/YR
Fusion Science and Technology=Fusion Sci. Technol.;FSTUCY;7/YR
Ganguang Kexue Yu Guang Huaxue=Ganguang Kexue Yu Guang Huaxue;GKKHE9;BM
Gaodeng Xuexiao Huaxue Xuebao=Gaodeng Xuexiao Huaxue Xuebao;KTHPDM;M
Gaofenzi Cailiao Kexue Yu Gongcheng=Gaofenzi Cailiao Kexue Yu Gongcheng;GCKGEI;BM
Gaofenzi Xuebao=Gaofenzi Xuebao;GAXUE9;BM
Gaoneng Wuli Yu Hewuli=Gaoneng Wuli Yu Hewuli;KNWLD9;M
Gaoxiao Huaxue Gongcheng Xuebao=Gaoxiao Huaxue Gongcheng Xuebao;GHGXEG;BM
Gene=Gene;GENED6;42/YR
Gene Expression Patterns=Gene Expression Patterns;GEPEAD;6/YR
Gene Therapy=Gene Ther.;GETHEC;SM
Gene Therapy and Regulation=Gene Ther. Regul.;GTREBR;IRR
General and Comparative Endocrinology=Gen. Comp. Endocrinol.;GCENA5;15/YR
Genes & Development=Genes Dev.;GEDEEP;SM
Genes to Cells=Genes Cells;GECEFL;M
Genes, Chromosomes & Cancer=Genes, Chromosomes Cancer;GCCAES;12/YR
Genome Research=Genome Res.;GEREFS;M
Genomics=Genomics;GNMCEP;M
Geochemical Journal=Geochem. J.;GEJOBE;BM
Geochimica et Cosmochimica Acta=Geochim. Cosmochim. Acta;GCACAK;SM
Geokhimiya=Geokhimiya;GEOKAQ;M
Glass Physics and Chemistry=Glass Phys. Chem.;GPHCEE;BM
Glass Science and Technology (Offenbach, Germany)=Glass Sci. Technol. (Offenbach, Ger.);GSTEEX;BM
Glass Technology=Glass Technol.;GLSTAK;BM
GlassResearcher=GlassResearcher;GRESER;SA
Global Biogeochemical Cycles=Global Biogeochem. Cycles;GBCYEP;Q
Glycobiology=Glycobiology;GLYCE3;M
Glycoconjugate Journal=Glycoconjugate J.;GLJOEW;9/YR
Gongneng Gaofenzi Xuebao=Gongneng Gaofenzi Xuebao;GGXUEH;Q
Ground Water=Ground Water;GRWAAP;BM
Growth Factors=Growth Factors;GRFAEC;Q
Guangpuxue Yu Guangpu Fenxi=Guangpuxue Yu Guangpu Fenxi;GYGFED;M
Guijinshu=Guijinshu;GUIJE7;Q
Guisuanyan Xuebao=Guisuanyan Xuebao;KSYHA5;M
Guocheng Gongcheng Xuebao=Guocheng Gongcheng Xuebao;CJPEB5;BM
Health Physics=Health Phys.;HLTPAO;M
Heat Transfer Engineering=Heat Transfer Eng.;HTEND2;8/YR
Hecheng Xiangjiao Gongye=Hecheng Xiangjiao Gongye;HXGOEA;BM
Helvetica Chimica Acta=Helv. Chim. Acta;HCACAV;M
Hemoglobin=Hemoglobin;HEMOD8;Q
Heteroatom Chemistry=Heteroat. Chem.;HETCE8;7/YR
Heterocycles=Heterocycles;HTCYAM;14/YR
Heterocyclic Communications=Heterocycl. Commun.;HCOMEX;BM
High Energy Chemistry=High Energy Chem.;HIECAP;BM
High Performance Polymers=High Perform. Polym.;HPPOEX;Q
High Temperature=High Temp.;HITEA4;BM
High Temperature Materials and Processes (London, United Kingdom)=High Temp. Mater. Processes (London, U. K.);HTMPEF;6/YR
High Temperatures - High Pressures=High Temp. - High Pressures;HTHPAK;BM
Histochemistry and Cell Biology=Histochem. Cell Biol.;HCBIFP;M
Holzforschung=Holzforschung;HOLZAZ;BM
Hormone and Metabolic Research=Horm. Metab. Res.;HMMRA2;M
Hormone Research=Horm. Res.;HRMRA3;M
Huadong Ligong Daxue Xuebao, Ziran Kexueban=Huadong Ligong Daxue Xuebao, Ziran Kexueban;HLIXEV;BM
Huagong Xuebao (Chinese Edition)=Huagong Xuebao (Chin. Ed.);HUKHAI;M
Huanjing Huaxue=Huanjing Huaxue;HUHUDB;BM
Huanjing Kexue Xuebao=Huanjing Kexue Xuebao;HKXUDL;M
Huaxue=Huaxue;HUHSA2;Q
Huaxue Fanying Gongcheng Yu Gongyi=Huaxue Fanying Gongcheng Yu Gongyi;HFGGEU;BM
Huaxue Shiji=Huaxue Shiji;HUSHDR;M
Huaxue Tongbao=Huaxue Tongbao;HHTPAU;M
Huaxue Wuli Xuebao=Huaxue Wuli Xuebao;HWXUE4;BM
Huaxue Xuebao=Huaxue Xuebao;HHHPA4;SM
Human Gene Therapy=Hum. Gene Ther.;HGTHE3;M
Human Molecular Genetics=Hum. Mol. Genet.;HMGEE5;26/YR
Hungarian Journal of Industrial Chemistry=Hung. J. Ind. Chem.;HJICAI;4/YR
Hwahak Konghak=Hwahak Konghak;HHKHAT;BM
Hydrometallurgy=Hydrometallurgy;HYDRDA;M
Hyperfine Interactions=Hyperfine Interact.;HYINDN;28/YR
Hypertension=Hypertension;HPRTDN;M
IEEE Journal of Quantum Electronics=IEEE J. Quantum Electron.;IEJQA7;M
IEEE Journal of Selected Topics in Quantum Electronics=IEEE J. Sel. Top. Quantum Electron.;IJSQEN;BM
ILAR Journal=ILAR J.;IJLOAC;Q
Immunity=Immunity;IUNIEH;M
Immunobiology=Immunobiology;IMMND4;IRR
Immunology=Immunology;IMMUAM;M
Immunology Letters=Immunol. Lett.;IMLED6;15/YR
Indian Chemical Engineer=Indian Chem. Eng.;ICENFW;Q
Indian Journal of Biochemistry & Biophysics=Indian J. Biochem. Biophys.;IJBBBQ;BM
Indian Journal of Chemical Technology=Indian J. Chem. Technol.;ICHTEU;BM
Anal. Chem. Indian Journal of Chemistry, Section A: Inorganic, Bio-inorganic, Physical, Theoretical & Analytical Chemistry=Indian J. Chem., Sect. A: Inorg., Bio-inorg., Phys., Theor.;ICACEC;M
Indian Journal of Chemistry, Section B: Organic Chemistry Including Medicinal Chemistry=Indian J. Chem., Sect. B: Org. Chem. Incl. Med. Chem.;IJSBDB;M
Indian Journal of Fibre & Textile Research=Indian J. Fibre Text. Res.;IJFRET;Q
Indian Journal of Heterocyclic Chemistry=Indian J. Heterocycl. Chem.;IJCHEI;Q
Indian Journal of Physics=Indian J. Phys.;IJPNCV;M
Indian Journal of Pure and Applied Physics=Indian J. Pure Appl. Phys.;IJOPAU;M
Industrial & Engineering Chemistry Research=Ind. Eng. Chem. Res.;IECRED;BW
Infection and Immunity=Infect. Immun.;INFIBR;M
Inflammation Research=Inflammation Res.;INREFB;M
Inhalation Toxicology=Inhalation Toxicol.;INHTE5;14/YR
Inorganic Chemistry=Inorg. Chem.;INOCAJ;BW
Inorganic Chemistry Communications=Inorg. Chem. Commun.;ICCOFP;M
Inorganic Materials=Inorg. Mater.;INOMAF;M
Inorganic Reaction Mechanisms (Philadelphia, PA, United States)=Inorg. React. Mech. (Philadelphia, PA, U. S.);IRMEFE;4/YR
Inorganica Chimica Acta=Inorg. Chim. Acta;ICHAA3;15/YR
Insect Biochemistry and Molecular Biology=Insect Biochem. Mol. Biol.;IBMBES;M
Insect Molecular Biology=Insect Mol. Biol.;IMBIE3;BM
Instrumentation Science & Technology=Instrum. Sci. Technol.;ISCTEF;6/YR
Intermetallics=Intermetallics;IERME5;M
International DATA Series, Selected Data on Mixtures, Series A: Thermodynamic Properties of Non-Reacting Binary Systems of Organic Substances=Int. DATA Ser., Sel. Data Mixtures, Ser. A;ISDMAT;Q
International Immunology=Int. Immunol.;INIMEN;M
International Immunopharmacology=Int. Immunopharmacol.;IINMBA;M
International Journal for Vitamin and Nutrition Research=Int. J. Vitam. Nutr. Res.;IJVNAP;BM
International Journal of Adhesion and Adhesives=Int. J. Adhes. Adhes.;IJAADK;BM
International Journal of Antimicrobial Agents=Int. J. Antimicrob. Agents;IAAGEA;M
International Journal of Applied Ceramic Technology=Int. J. Appl. Ceram. Technol.;IJACCP;BM
International Journal of Biochemistry & Cell Biology=Int. J. Biochem. Cell Biol.;IJBBFU;M
International Journal of Biological Macromolecules=Int. J. Biol. Macromol.;IJBMDR;9/YR
International Journal of Cancer=Int. J. Cancer;IJCNAW;30/YR
International Journal of Chemical Kinetics=Int. J. Chem. Kinet.;IJCKBO;M
International Journal of Chemistry=Int. J. Chem.;INJCEW;Q
International Journal of Coal Geology=Int. J. Coal Geol.;IJCGDE;M
International Journal of Environment and Pollution=Int. J. Environ. Pollut.;IJVLEN;12/YR
International Journal of Environmental Analytical Chemistry=Int. J. Environ. Anal. Chem.;IJEAA3;15/YR
International Journal of Food Science and Technology=Int. J. Food Sci. Technol.;IJFTEZ;10/YR
International Journal of Hydrogen Energy=Int. J. Hydrogen Energy;IJHEDX;15/YR
International Journal of Immunogenetics=Int. J. Immunogenet.;IJINCU;BM
International Journal of Mass Spectrometry=Int. J. Mass Spectrom.;IMSPF8;SM
International Journal of Mineral Processing=Int. J. Miner. Process.;IJMPBL;M
International Journal of Multiphase Flow=Int. J. Multiphase Flow;IJMFBP;M
International Journal of Nanoscience=Int. J. Nanosci.;IJNNAJ;BM
International Journal of Non-Equilibrium Processing=Int. J. Non-Equilib. Process.;IJNPFU;IRR
International Journal of Peptide Research and Therapeutics=Int. J. Pept. Res. Ther.;IJPRFC;Q
International Journal of Pharmaceutics=Int. J. Pharm.;IJPHDE;38/YR
International Journal of PIXE=Int. J. PIXE;IJPXET;2/YR
International Journal of Polymer Analysis and Characterization=Int. J. Polym. Anal. Charact.;IPACEZ;BM
International Journal of Polymeric Materials=Int. J. Polym. Mater.;IJPMCS;M
International Journal of Powder Metallurgy (Princeton, New Jersey)=Int. J. Powder Metall. (Princeton, N. J.);IPMTEA;BM
International Journal of Quantum Chemistry=Int. J. Quantum Chem.;IJQCB2;30/YR
International Journal of Radiation Biology=Int. J. Radiat. Biol.;IJRBE7;M
International Journal of Refractory Metals & Hard Materials=Int. J. Refract. Met. Hard Mater.;IRMME3;BM
International Journal of Thermophysics=Int. J. Thermophys.;IJTHDY;BM
International Materials Reviews=Int. Mater. Rev.;INMREO;BM
International Polymer Processing=Int. Polym. Process.;IPPREJ;Q
International Reviews in Physical Chemistry=Int. Rev. Phys. Chem.;IRPCDL;Q
Ionics=Ionics;IONIFA;BM
Ironmaking and Steelmaking=Ironmaking Steelmaking;IMKSB7;BM
ISIJ International=ISIJ Int.;IINTEY;M
Isotopes in Environmental and Health Studies=Isot. Environ. Health Stud.;IEHSF8;4/YR
Israel Journal of Chemistry=Isr. J. Chem.;ISJCAT;Q
Italian Journal of Biochemistry=Ital. J. Biochem.;IJBIAC;Q
IUBMB Life=IUBMB Life;IULIF8;M
Izvestiya Natsional'noi Akademii Nauk Respubliki Kazakhstan, Seriya Khimicheskaya=Izv. Nats. Akad. Nauk Resp. Kaz., Ser. Khim.;INANDJ;BM
Izvestiya Rossiiskoi Akademii Nauk, Seriya Fizicheskaya=Izv. Ross. Akad. Nauk, Ser. Fiz.;IRAFEO;M
Izvestiya Vysshikh Uchebnykh Zavedenii, Khimiya i Khimicheskaya Tekhnologiya=Izv. Vyssh. Uchebn. Zaved., Khim. Khim. Tekhnol.;IVUKAR;9/YR
Izvestiya Vysshikh Uchebnykh Zavedenii, Tsvetnaya Metallurgiya=Izv. Vyssh. Uchebn. Zaved., Tsvetn. Metall.;IVUTAK;6/YR
JAMA, the Journal of the American Medical Association=JAMA, J. Am. Med. Assoc.;JAMAAP;48/YR
Japanese Journal of Applied Physics, Part 1: Regular Papers, Brief Communications & Review Papers=Jpn. J. Appl. Phys., Part 1;JAPNDE;M
Japanese Journal of Applied Physics, Part 2: Letters & Express Letters=Jpn. J. Appl. Phys., Part 2;JAPLD8;SM
JBIC, Journal of Biological Inorganic Chemistry=JBIC, J. Biol. Inorg. Chem.;JJBCFA;8/YR
JCT Research=JCT Res.;JRCEB5;Q
JETP Letters=JETP Lett.;JTPLA2;SM
Jiegou Huaxue=Jiegou Huaxue;JHUADF;M
Jinshu Xuebao=Jinshu Xuebao;CHSPA4;M
Jisuanji Yu Yingyong Huaxue=Jisuanji Yu Yingyong Huaxue;JYYHE6;M
Journal - American Water Works Association=J. - Am. Water Works Assoc.;JAWWA5;M
Journal de Pharmacie de Belgique=J. Pharm. Belg.;JPBEAJ;4/YR
Journal of Adhesion=J. Adhes.;JADNAJ;M
Journal of Adhesion Science and Technology=J. Adhes. Sci. Technol.;JATEE8;16/YR
Journal of Advances in Chemical Physics=J. Adv. Chem. Phys.;JACPCM;M
Journal of Aerosol Science=J. Aerosol Sci.;JALSB7;13/YR
Journal of Agricultural and Food Chemistry=J. Agric. Food Chem.;JAFCAU;BW
Journal of Alloys and Compounds=J. Alloys Compd.;JALCEU;36/YR
Journal of Analytical and Applied Pyrolysis=J. Anal. Appl. Pyrolysis;JAAPDD;BM
Journal of Analytical Atomic Spectrometry=J. Anal. At. Spectrom.;JASPE2;M
Journal of Analytical Chemistry=J. Anal. Chem.;JACTE2;M
Journal of Analytical Toxicology=J. Anal. Toxicol.;JATOD3;8/YR
Journal of Animal Science (Savoy, IL, United States)=J. Anim. Sci. (Savoy, IL, U. S.);JANSAG;M
Journal of Antibiotics=J. Antibiot.;JANTAJ;M
Journal of Antimicrobial Chemotherapy=J. Antimicrob. Chemother.;JACHDX;M
Journal of AOAC International=J. AOAC Int.;JAINEE;BM
Journal of Applied Animal Welfare Science=J. Appl. Anim. Welfare Sci.;JAAWAV;Q
Journal of Applied Crystallography=J. Appl. Crystallogr.;JACGAR;BM
Journal of Applied Electrochemistry=J. Appl. Electrochem.;JAELBJ;M
Journal of Applied Physics=J. Appl. Phys.;JAPIAU;SM
Journal of Applied Polymer Science=J. Appl. Polym. Sci.;JAPNAB;SM
Journal of Applied Spectroscopy=J. Appl. Spectrosc.;JASYAP;BM
Journal of Applied Toxicology=J. Appl. Toxicol.;JJATDK;BM
Journal of Atmospheric Chemistry=J. Atmos. Chem.;JATCE2;9/YR
Journal of Automated Methods & Management in Chemistry=J. Autom. Methods Manage. Chem.;JAMCF2;BM
Journal of Bacteriology=J. Bacteriol.;JOBAAY;SM
Journal of Biochemical and Biophysical Methods=J. Biochem. Biophys. Methods;JBBMDG;M
Journal of Biochemical and Molecular Toxicology=J. Biochem. Mol. Toxicol.;JBMTFQ;BM
Journal of Biochemistry (Tokyo, Japan)=J. Biochem. (Tokyo, Jpn.);JOBIAO;M
Journal of Biochemistry and Molecular Biology=J. Biochem. Mol. Biol.;JBMBE5;BM
Journal of Bioenergetics and Biomembranes=J. Bioenerg. Biomembr.;JBBID4;BM
Journal of Biological Chemistry=J. Biol. Chem.;JBCHA3;W
Journal of Biomaterials Science, Polymer Edition=J. Biomater. Sci., Polym. Ed.;JBSEEA;M
Journal of Biomedical Materials Research, Part A=J. Biomed. Mater. Res., Part A;JBMRCH;16/YR
Journal of Biomedical Materials Research, Part B: Applied Biomaterials=J. Biomed. Mater. Res., Part B;JBMRGL;8/YR
Journal of Biomedical Nanotechnology=J. Biomed. Nanotechnol.;JBNOAB;Q
Journal of Biomolecular NMR=J. Biomol. NMR;JBNME9;M
Journal of Biomolecular Structure & Dynamics=J. Biomol. Struct. Dyn.;JBSDD6;BM
Journal of Bioscience and Bioengineering=J. Biosci. Bioeng.;JBBIF6;M
Journal of Biotechnology=J. Biotechnol.;JBITD4;SM
Journal of Capillary Electrophoresis and Microchip Technology=J. Capillary Electrophor. Microchip Technol.;JCEMF6;6/YR
Journal of Carbohydrate Chemistry=J. Carbohydr. Chem.;JCACDM;9/YR
Journal of Cardiovascular Pharmacology=J. Cardiovasc. Pharmacol.;JCPCDT;M
Journal of Catalysis=J. Catal.;JCTLA5;16/YR
Journal of Cell Biology=J. Cell Biol.;JCLBA3;BW
Journal of Cell Science=J. Cell Sci.;JNCSAI;24/YR
Journal of Cellular Biochemistry=J. Cell. Biochem.;JCEBD5;18/YR
Journal of Cellular Physiology=J. Cell. Physiol.;JCLLAX;M
Journal of Chemical and Engineering Data=J. Chem. Eng. Data;JCEAAX;BM
Journal of Chemical Crystallography=J. Chem. Crystallogr.;JCCYEV;M
Journal of Chemical Ecology=J. Chem. Ecol.;JCECD8;M
Journal of Chemical Education=J. Chem. Educ.;JCEDA8;M
Journal of Chemical Engineering of Japan=J. Chem. Eng. Jpn.;JCEJAQ;M
Journal of Chemical Information and Modeling=J. Chem. Inf. Model.;JCISD8;BM
Journal of Chemical Physics=J. Chem. Phys.;JCPSA6;48/YR
Journal of Chemical Research=J. Chem. Res.;JCROA4;M
Journal of Chemical Sciences (Bangalore, India)=J. Chem. Sci. (Bangalore, India);JCSBB5;BM
Journal of Chemical Technology and Biotechnology=J. Chem. Technol. Biotechnol.;JCTBED;M
Journal of Chemical Theory and Computation=J. Chem. Theory Comput.;JCTCCE;BM
Journal of Chemical Thermodynamics=J. Chem. Thermodyn.;JCTDAF;M
Journal of Chemometrics=J. Chemom.;JOCHEU;M
Journal of Chromatographic Science=J. Chromatogr. Sci.;JCHSBZ;10/YR
Journal of Chromatography, A=J. Chromatogr., A;JCRAEY;78/YR
Journal of Chromatography, B: Analytical Technologies in the Biomedical and Life Sciences=J. Chromatogr., B: Anal. Technol. Biomed. Life Sci.;JCBAAI;23/YR
Journal of Clinical Endocrinology and Metabolism=J. Clin. Endocrinol. Metab.;JCEMAZ;M
Journal of Clinical Investigation=J. Clin. Invest.;JCINAO;M
Journal of Cluster Science=J. Cluster Sci.;JCSCEB;Q
Journal of Colloid and Interface Science=J. Colloid Interface Sci.;JCISA5;SM
Journal of Combinatorial Chemistry=J. Comb. Chem.;JCCHFF;BM
Journal of Computational and Theoretical Nanoscience=J. Comput. Theor. Nanosci.;JCTNAB;4/YR
Journal of Computational Biology=J. Comput. Biol.;JCOBEM;10/yr
Journal of Computational Chemistry=J. Comput. Chem.;JCCHDD;16/YR
Journal of Computer Chemistry, Japan=J. Comput. Chem., Jpn.;JCCJAG;Q
Journal of Computer-Aided Molecular Design=J. Comput.-Aided Mol. Des.;JCADEQ;M
Journal of Contaminant Hydrology=J. Contam. Hydrol.;JCOHE6;32/YR
Journal of Controlled Release=J. Controlled Release;JCREEC;24/yr
Journal of Coordination Chemistry=J. Coord. Chem.;JCCMBQ;18/YR
Journal of Crystal Growth=J. Cryst. Growth;JCRGAE;SM
Journal of Dairy Research=J. Dairy Res.;JDRSAN;Q
Journal of Dairy Science=J. Dairy Sci.;JDSCAE;M
Journal of Dispersion Science and Technology=J. Dispersion Sci. Technol.;JDTEDS;BM
Journal of Drug Targeting=J. Drug Targeting;JDTAEH;10/YR
Journal of Electroanalytical Chemistry=J. Electroanal. Chem.;JECHES;26/YR
Journal of Electron Spectroscopy and Related Phenomena=J. Electron Spectrosc. Relat. Phenom.;JESRAW;21/YR
Journal of Electronic Materials=J. Electron. Mater.;JECMA5;M
Journal of Endocrinology=J. Endocrinol.;JOENAK;M
Journal of Endotoxin Research=J. Endotoxin Res.;JENREB;BM
Journal of Energetic Materials=J. Energ. Mater.;JOEMDK;Q
Journal of Environmental Engineering (Reston, VA, United States)=J. Environ. Eng. (Reston, VA, U. S.);JOEEDU;M
Journal of Environmental Monitoring=J. Environ. Monit.;JEMOFW;M
Journal of Environmental Quality=J. Environ. Qual.;JEVQAA;BM
Journal of Environmental Radioactivity=J. Environ. Radioact.;JERAEE;21/YR
Journal of Environmental Science & Engineering=J. Environ. Sci. Eng.;JESEAR;Q
Environ. Eng. Journal of Environmental Science and Health, Part A: Toxic/Hazardous Substances & Environmental Engineering=J. Environ. Sci. Health, Part A: Toxic/Hazard. Subst.;JATEF9;M
Journal of Environmental Science and Health, Part B: Pesticides, Food Contaminants, and Agricultural Wastes=J. Environ. Sci. Health, Part B;JPFCD2;BM
Journal of Enzyme Inhibition and Medicinal Chemistry=J. Enzyme Inhib. Med. Chem.;JEIMAZ;BM
Journal of Experimental and Theoretical Physics=J. Exp. Theor. Phys.;JTPHES;M
Journal of Experimental Animal Science=J. Exp. Anim. Sci.;JEXSEU;4/YR
Journal of Experimental Botany=J. Exp. Bot.;JEBOA6;M
Journal of Experimental Medicine=J. Exp. Med.;JEMEAV;SM
Journal of Fluorine Chemistry=J. Fluorine Chem.;JFLCAR;M
Journal of Food Science=J. Food Sci.;JFDSAZ;9/YR
Journal of Fusion Energy=J. Fusion Energy;JFENDS;Q
Journal of General and Applied Microbiology=J. Gen. Appl. Microbiol.;JGAMA9;BM
Journal of General Virology=J. Gen. Virol.;JGVIAY;M
Journal of Genome Science and Technology=J. Genome Sci. Technol.;JGSTAI;Q
Journal of Geochemical Exploration=J. Geochem. Explor.;JGCEAT;BM
Journal of Hazardous Materials=J. Hazard. Mater.;JHMAD9;21/YR
Journal of Heterocyclic Chemistry=J. Heterocycl. Chem.;JHTCAD;BM
Journal of Histochemistry and Cytochemistry=J. Histochem. Cytochem.;JHCYAS;M
Journal of Hypertension=J. Hypertens.;JOHYD3;M
Journal of Imaging Science and Technology=J. Imaging Sci. Technol.;JIMTE6;BM
Journal of Immunoassay & Immunochemistry=J. Immunoassay Immunochem.;JIIOAZ;Q
Journal of Immunological Methods=J. Immunol. Methods;JIMMBG;M
Journal of Immunology=J. Immunol.;JOIMA3;SM
Journal of Inclusion Phenomena and Macrocyclic Chemistry=J. Inclusion Phenom. Macrocyclic Chem.;JIPCF5;M
Journal of Industrial and Engineering Chemistry (Seoul, Republic of Korea)=J. Ind. Eng. Chem. (Seoul, Repub. Korea);JIECFI;BM
Journal of Industrial Microbiology & Biotechnology=J. Ind. Microbiol. Biotechnol.;JIMBFL;M
Journal of Inorganic and Organometallic Polymers and Materials=J. Inorg. Organomet. Polym. Mater.;JIOPAY;Q
Journal of Inorganic Biochemistry=J. Inorg. Biochem.;JIBIDJ;M
Journal of Insect Physiology=J. Insect Physiol.;JIPHAF;M
Journal of Interferon & Cytokine Research=J. Interferon Cytokine Res.;JICRFJ;M
Journal of Investigative Dermatology=J. Invest. Dermatol.;JIDEAE;M
Journal of Labelled Compounds & Radiopharmaceuticals=J. Labelled Compd. Radiopharm.;JLCRD4;14/YR
Journal of Leukocyte Biology=J. Leukocyte Biol.;JLBIE7;M
Journal of Lipid Research=J. Lipid Res.;JLPRAW;M
Journal of Liquid Chromatography & Related Technologies=J. Liq. Chromatogr. Relat. Technol.;JLCTFC;20/YR
Journal of Low Temperature Physics=J. Low Temp. Phys.;JLTPAC;M
Journal of Luminescence=J. Lumin.;JLUMA8;20/YR
Journal of Macromolecular Science, Part A: Pure and Applied Chemistry=J. Macromol. Sci., Part A: Pure Appl. Chem.;JSPCE6;M
Journal of Macromolecular Science, Part B: Physics=J. Macromol. Sci., Part B: Phys.;JMAPBR;BM
Journal of Macromolecular Science, Polymer Reviews=J. Macromol. Sci., Polym. Rev.;JMSPCG;Q
Journal of Magnetic Resonance=J. Magn. Reson.;JMARF3;M
Journal of Magnetism and Magnetic Materials=J. Magn. Magn. Mater.;JMMMDC;45/YR
Journal of Mass Spectrometry=J. Mass Spectrom.;JMSPFJ;M
Journal of Materials Chemistry=J. Mater. Chem.;JMACEP;48/YR
Journal of Materials Engineering and Performance=J. Mater. Eng. Perform.;JMEPEG;BM
Journal of Materials Research=J. Mater. Res.;JMREEE;M
Journal of Materials Science=J. Mater. Sci.;JMTSAS;SM
Journal of Materials Science: Materials in Electronics=J. Mater. Sci.: Mater. Electron.;JSMEEV;M
Journal of Materials Science: Materials in Medicine=J. Mater. Sci.: Mater. Med.;JSMMEL;M
Journal of Mathematical Chemistry=J. Math. Chem.;JMCHEG;8/YR
Journal of Medicinal Chemistry=J. Med. Chem.;JMCMAR;BW
Journal of Membrane Biology=J. Membr. Biol.;JMBBBO;18/YR
Journal of Membrane Science=J. Membr. Sci.;JMESDO;36/YR
Journal of Microencapsulation=J. Microencapsulation;JOMIEF;8/YR
Journal of Molecular and Cellular Cardiology=J. Mol. Cell. Cardiol.;JMCDAY;M
Journal of Molecular Biology=J. Mol. Biol.;JMOBAK;50/YR
Journal of Molecular Catalysis A: Chemical=J. Mol. Catal. A: Chem.;JMCCF2;SM
Journal of Molecular Catalysis B: Enzymatic=J. Mol. Catal. B: Enzym.;JMCEF8;8/YR
Journal of Molecular Endocrinology=J. Mol. Endocrinol.;JMLEEI;BM
Journal of Molecular Evolution=J. Mol. Evol.;JMEVAU;M
Journal of Molecular Graphics & Modelling=J. Mol. Graphics Modell.;JMGMFI;BM
Journal of Molecular Liquids=J. Mol. Liq.;JMLIDT;21/YR
Journal of Molecular Microbiology and Biotechnology=J. Mol. Microbiol. Biotechnol.;JMMBFF;8/YR
Journal of Molecular Neuroscience=J. Mol. Neurosci.;JMNEES;BM
Journal of Molecular Recognition=J. Mol. Recognit.;JMORE4;BM
Journal of Molecular Spectroscopy=J. Mol. Spectrosc.;JMOSA3;M
Journal of Molecular Structure=J. Mol. Struct.;JMOSB4;66/YR
Journal of Nanoscience and Nanotechnology=J. Nanosci. Nanotechnol.;JNNOAR;M
Journal of Natural Gas Chemistry=J. Nat. Gas Chem.;JGCHE8;Q
Journal of Natural Products=J. Nat. Prod.;JNPRDF;M
Journal of Near Infrared Spectroscopy=J. Near Infrared Spectrosc.;JNISEI;BM
Journal of Neurochemistry=J. Neurochem.;JONRA9;SM
Journal of Neuroendocrinology=J. Neuroendocrinol.;JOUNE2;M
Journal of Neuroimmunology=J. Neuroimmunol.;JNRIDW;24/YR
Journal of Neuroscience=J. Neurosci.;JNRSDS;W
Journal of Neuroscience Research=J. Neurosci. Res.;JNREDK;SM
Journal of Non-Crystalline Solids=J. Non-Cryst. Solids;JNCSBJ;54/YR
Journal of Non-Newtonian Fluid Mechanics=J. Non-Newtonian Fluid Mech.;JNFMDI;24/YR
Journal of Nuclear Materials=J. Nucl. Mater.;JNUMAM;36/YR
Journal of Nuclear Science and Technology (Tokyo, Japan)=J. Nucl. Sci. Technol. (Tokyo, Jpn.);JNSTAX;M
Journal of Nutrition=J. Nutr.;JONUAI;M
Journal of Nutritional Biochemistry=J. Nutr. Biochem.;JNBIEL;M
Journal of Nutritional Science and Vitaminology=J. Nutr. Sci. Vitaminol.;JNSVA5;BM
Journal of Ocular Pharmacology and Therapeutics=J. Ocul. Pharmacol. Ther.;JOPTFU;BM
Journal of Oleo Science=J. Oleo Sci.;JOSOAP;M
Journal of Organic Chemistry=J. Org. Chem.;JOCEAH;BW
Journal of Organometallic Chemistry=J. Organomet. Chem.;JORCAI;BW
Journal of Peptide Research=J. Pept. Res.;JPERFA;M
Journal of Peptide Science=J. Pept. Sci.;JPSIEI;M
Journal of Petroleum Science & Engineering=J. Pet. Sci. Eng.;JPSEE6;8/YR
Journal of Petrology=J. Petrol.;JPTGAD;M
Journal of Pharmaceutical and Biomedical Analysis=J. Pharm. Biomed. Anal.;JPBADA;15/YR
Journal of Pharmaceutical Sciences=J. Pharm. Sci.;JPMSAE;M
Journal of Pharmacological and Toxicological Methods=J. Pharmacol. Toxicol. Methods;JPTMEZ;BM
Journal of Pharmacological Sciences (Tokyo, Japan)=J. Pharmacol. Sci. (Tokyo, Jpn.);JPSTGJ;M
Journal of Pharmacology and Experimental Therapeutics=J. Pharmacol. Exp. Ther.;JPETAB;M
Journal of Pharmacy and Pharmacology=J. Pharm. Pharmacol.;JPPMAB;M
Journal of Phase Equilibria and Diffusion=J. Phase Equilib. Diffus.;JPEDAV;BM
Journal of Photochemistry and Photobiology, A: Chemistry=J. Photochem. Photobiol., A;JPPCEJ;30/YR
Journal of Photochemistry and Photobiology, B: Biology=J. Photochem. Photobiol., B;JPPBEG;M
Journal of Photochemistry and Photobiology, C: Photochemistry Reviews=J. Photochem. Photobiol., C;JPPCAF;4/YR
Journal of Photopolymer Science and Technology=J. Photopolym. Sci. Technol.;JSTEEW;5/YR
Journal of Physical and Chemical Reference Data=J. Phys. Chem. Ref. Data;JPCRBU;Q
Journal of Physical Chemistry A=J. Phys. Chem. A;JPCAFH;W
Journal of Physical Chemistry B=J. Phys. Chem. B;JPCBFK;W
Journal of Physical Organic Chemistry=J. Phys. Org. Chem.;JPOCEE;M
Journal of Physics and Chemistry of Solids=J. Phys. Chem. Solids;JPCSAW;M
Journal of Physics B: Atomic, Molecular and Optical Physics=J. Phys. B: At., Mol. Opt. Phys.;JPAPEH;SM
Journal of Physics D: Applied Physics=J. Phys. D: Appl. Phys.;JPAPBE;SM
Journal of Physics G: Nuclear and Particle Physics=J. Phys. G: Nucl. Part. Phys.;JPGPED;M
Journal of Physics: Condensed Matter=J. Phys.: Condens. Matter;JCOMEL;50/YR
Journal of Physiology (Oxford, United Kingdom)=J. Physiol. (Oxford, U. K.);JPHYA7;SM
Journal of Pineal Research=J. Pineal Res.;JPRSE9;8/YR
Journal of Planar Chromatography--Modern TLC=J. Planar Chromatogr.--Mod. TLC;JPCTE5;BM
Journal of Plant Growth Regulation=J. Plant Growth Regul.;JPGRDI;Q
Journal of Plant Nutrition=J. Plant Nutr.;JPNUDS;M
Journal of Plant Nutrition and Soil Science=J. Plant Nutr. Soil Sci.;JNSSFZ;BM
Journal of Plant Physiology=J. Plant Physiol.;JPPHEY;M
Journal of Polymer Materials=J. Polym. Mater.;JOPME8;Q
Journal of Polymer Research=J. Polym. Res.;JPOREP;Q
Journal of Polymer Science, Part A: Polymer Chemistry=J. Polym. Sci., Part A: Polym. Chem.;JPACEC;SM
Journal of Polymer Science, Part B: Polymer Physics=J. Polym. Sci., Part B: Polym. Phys.;JPBPEM;SM
Journal of Polymers and the Environment=J. Polym. Environ.;JPENFW;Q
Journal of Porphyrins and Phthalocyanines=J. Porphyrins Phthalocyanines;JPPHFZ;M
Journal of Power Sources=J. Power Sources;JPSODZ;24/YR
Journal of Process Control=J. Process Control;JPCOEO;8/YR
Journal of Proteome Research=J. Proteome Res.;JPROBS;BM
Journal of Pulp and Paper Science=J. Pulp Pap. Sci.;JPUSDN;Q
Journal of Quantitative Spectroscopy & Radiative Transfer=J. Quant. Spectrosc. Radiat. Transfer;JQSRAE;28/YR
Journal of Radioanalytical and Nuclear Chemistry=J. Radioanal. Nucl. Chem.;JRNCDM;M
Journal of Raman Spectroscopy=J. Raman Spectrosc.;JRSPAF;M
Journal of Receptors and Signal Transduction=J. Recept. Signal Transduction;JRSTCT;Q
Journal of Reinforced Plastics and Composites=J. Reinf. Plast. Compos.;JRPCDW;18/YR
Journal of Rheology (New York, NY, United States)=J. Rheol. (N. Y., NY, U. S.);JORHD2;BM
Journal of Separation Science=J. Sep. Sci.;JSSCCJ;18/YR
Journal of Sol-Gel Science and Technology=J. Sol-Gel Sci. Technol.;JSGTEC;12/YR
Journal of Solid State Chemistry=J. Solid State Chem.;JSSCBI;12/YR
Journal of Solid State Electrochemistry=J. Solid State Electrochem.;JSSEFS;12/YR
Journal of Solution Chemistry=J. Solution Chem.;JSLCAG;M
Journal of Steroid Biochemistry and Molecular Biology=J. Steroid Biochem. Mol. Biol.;JSBBEZ;SM
Journal of Structural and Functional Genomics=J. Struct. Funct. Genomics;JSFGAW;Q
Journal of Structural Chemistry=J. Struct. Chem.;JSTCAM;BM
Journal of Sulfur Chemistry=J. Sulfur Chem.;JSCOFC;BM
Journal of Superconductivity=J. Supercond.;JOUSEH;BM
Journal of Supercritical Fluids=J. Supercrit. Fluids;JSFLEH;9/yr
Journal of Surfactants and Detergents=J. Surfactants Deterg.;JSDEFL;Q
Journal of the American Ceramic Society=J. Am. Ceram. Soc.;JACTAW;M
Journal of the American Chemical Society=J. Am. Chem. Soc.;JACSAT;W
Journal of the American Oil Chemists' Society=J. Am. Oil Chem. Soc.;JAOCA7;M
Journal of the American Society for Mass Spectrometry=J. Am. Soc. Mass Spectrom.;JAMSEF;M
Journal of the American Society of Brewing Chemists=J. Am. Soc. Brew. Chem.;JSBCD3;Q
Journal of the Argentine Chemical Society=J. Argent. Chem. Soc.;JACSFY;2/YR
Journal of the Brazilian Chemical Society=J. Braz. Chem. Soc.;JOCSET;BM
Journal of the Ceramic Society of Japan=J. Ceram. Soc. Jpn.;JCSJEW;M
Journal of the Chemical Society of Pakistan=J. Chem. Soc. Pak.;JCSPDF;Q
Journal of the Chilean Chemical Society=J. Chil. Chem. Soc.;JCCSCB;Q
Journal of the Chinese Chemical Society (Taipei, Taiwan)=J. Chin. Chem. Soc. (Taipei, Taiwan);JCCTAC;BM
Journal of the Chinese Institute of Chemical Engineers=J. Chin. Inst. Chem. Eng.;JCICAP;BM
Journal of the Electrochemical Society=J. Electrochem. Soc.;JESOAN;M
Journal of the Electrochemical Society of India=J. Electrochem. Soc. India;JESIA5;Q
Journal of the Energy Institute=J. Energy Inst.;JEIOB8;4/YR
Journal of the European Ceramic Society=J. Eur. Ceram. Soc.;JECSER;16/YR
Journal of the Indian Chemical Society=J. Indian Chem. Soc.;JICSAH;M
Journal of the Institution of Chemists (India)=J. Inst. Chem. (India);JOICA7;BM
Journal of the Japan Petroleum Institute=J. Jpn. Pet. Inst.;JJPIAP;BM
Journal of the Korean Ceramic Society=J. Korean Ceram. Soc.;JKCSBW;M
Journal of the Korean Chemical Society=J. Korean Chem. Soc.;JKCSEZ;BM
Journal of the Optical Society of America B: Optical Physics=J. Opt. Soc. Am. B;JOBPDE;M
Journal of the Physical Society of Japan=J. Phys. Soc. Jpn.;JUPSAU;M
Journal of the Science of Food and Agriculture=J. Sci. Food Agric.;JSFAAE;15/YR
Journal of the Serbian Chemical Society=J. Serb. Chem. Soc.;JSCSEN;M
Journal of the Society of Inorganic Materials, Japan=J. Soc. Inorg. Mater., Jpn.;JSIJFR;BM
Journal of Theoretical & Computational Chemistry=J. Theor. Comput. Chem.;JTCCAC;Q
Journal of Thermal Analysis and Calorimetry=J. Therm. Anal. Calorim.;JTACF7;M
Journal of Thermophysics and Heat Transfer=J. Thermophys. Heat Transfer;JTHTEO;Q
Journal of Toxicology and Environmental Health, Part A=J. Toxicol. Environ. Health, Part A;JTEHF8;SM
Journal of Toxicology and Environmental Health, Part B: Critical Reviews=J. Toxicol. Environ. Health, Part B;JTECFR;BM
Journal of Vacuum Science & Technology, A: Vacuum, Surfaces, and Films=J. Vac. Sci. Technol., A;JVTAD6;BM
Struct.--Process., Meas., Phenom. Journal of Vacuum Science & Technology, B: Microelectronics and Nanometer Structures--Processing, Measurement, and Phenomena=J. Vac. Sci. Technol., B: Microelectron. Nanometer;JVSTBM;BM
Journal of Vinyl & Additive Technology=J. Vinyl Addit. Technol.;JVATF4;Q
Journal of Virological Methods=J. Virol. Methods;JVMEDH;16/yr
Journal of Virology=J. Virol.;JOVIAM;SM
Journal of Volcanology and Geothermal Research=J. Volcanol. Geotherm. Res.;JVGRDQ;40/YR
Journal of Wood Chemistry and Technology=J. Wood Chem. Technol.;JWCTDJ;4/YR
Kagaku Kogaku=Kagaku Kogaku;KKGKA4;M
Kagaku Kogaku Ronbunshu=Kagaku Kogaku Ronbunshu;KKRBAW;BM
Kemija u Industriji=Kem. Ind.;KJUIAR;M
KGK, Kautschuk Gummi Kunststoffe=KGK, Kautsch. Gummi Kunstst.;KKGKB5;10/YR
Khimicheskaya Promyshlennost (St. Petersburg, Russian Federation)=Khim. Prom-st. (St. Petersburg, Russ. Fed.);KPRMAW;M
Khimicheskaya Promyshlennost Segodnya=Khim. Prom-st. Segodnya;KPSHBN;M
Khimiya i Tekhnologiya Vody=Khim. Tekhnol. Vody;KTVODL;BM
Khimiya Tverdogo Topliva (Moscow, Russian Federation)=Khim. Tverd. Topl. (Moscow, Russ. Fed.);KTVTBY;BM
Khimiya v Interesakh Ustoichivogo Razvitiya=Khim. Interesakh Ustoich. Razvit.;KIURFI;BM
Kinetics and Catalysis=Kinet. Catal.;KICAA8;BM
Kobunshi Ronbunshu=Kobunshi Ronbunshu;KBRBA3;M
Koks i Khimiya=Koks Khim.;KOKKAI;M
Korean Journal of Chemical Engineering=Korean J. Chem. Eng.;KJCHE6;BM
Lab on a Chip=Lab Chip;LCAHAM;12/YR
Laboratory Animals=Lab. Anim.;LBANAX;Q
Langmuir=Langmuir;LANGD5;BW
Laser and Particle Beams=Laser Part. Beams;LPBEDA;Q
Latvijas Kimijas Zurnals=Latv. Kim. Z.;LKZUE8;Q
LCGC North America=LCGC North Am.;LNACBH;M
Letters in Drug Design & Discovery=Lett. Drug Des. Discovery;LDDDAW;8/YR
Letters in Organic Chemistry=Lett. Org. Chem.;LOCEC7;8/YR
Life Sciences=Life Sci.;LIFSAK;W
Linchan Huaxue Yu Gongye=Linchan Huaxue Yu Gongye;LHYGD7;Q
Lipids=Lipids;LPDSAP;M
Liquid Crystals=Liq. Cryst.;LICRE6;M
Lithos=Lithos;LITHAN;28/YR
LWT--Food Science and Technology=LWT--Food Sci. Technol.;LSTWB3;8/YR
Macromolecular Bioscience=Macromol. Biosci.;MBAIBU;M
Macromolecular Chemistry and Physics=Macromol. Chem. Phys.;MCHPES;SM
Macromolecular Materials and Engineering=Macromol. Mater. Eng.;MMENFA;M
Macromolecular Rapid Communications=Macromol. Rapid Commun.;MRCOE3;24/YR
Macromolecular Research=Macromol. Res.;MRAECT;BM
Macromolecular Symposia=Macromol. Symp.;MSYMEC;IRR
Macromolecular Theory and Simulations=Macromol. Theory Simul.;MTHSEK;9/YR
Macromolecules=Macromolecules;MAMOBX;BW
Magnesium Research=Magnesium Res.;MAGREF;Q
Magnetic Resonance in Chemistry=Magn. Reson. Chem.;MRCHEG;M
Magyar Kemiai Folyoirat, Kemiai Kozlemenyek=Magy. Kem. Foly., Kem. Kozl.;MKFKAL;Q
Main Group Metal Chemistry=Main Group Met. Chem.;MGMCE8;BM
Marine Biotechnology=Mar. Biotechnol.;MABIFW;BM
Marine Chemistry=Mar. Chem.;MRCHBD;20/YR
Marine Environmental Research=Mar. Environ. Res.;MERSDW;10/YR
Marine Pollution Bulletin=Mar. Pollut. Bull.;MPNBAZ;IRR
Materials and Corrosion=Mater. Corros.;MTCREQ;M
Materials and Manufacturing Processes=Mater. Manuf. Processes;MMAPET;BM
Materials Characterization=Mater. Charact.;MACHEX;10/YR
Materials Chemistry and Physics=Mater. Chem. Phys.;MCHPDR;M
Materials Forum=Mater. Forum;MFOREM;A
Materials Letters=Mater. Lett.;MLETDJ;SM
Materials Research Bulletin=Mater. Res. Bull.;MRBUAC;15/YR
Materials Research Innovations=Mater. Res. Innovations;MRINFV;6/YR
Materials Research Society Symposium Proceedings=Mater. Res. Soc. Symp. Proc.;MRSPDH;IRR
Materials Science & Engineering, A: Structural Materials: Properties, Microstructure and Processing=Mater. Sci. Eng., A;MSAPE3;46/YR
Materials Science & Engineering, B: Solid-State Materials for Advanced Technology=Mater. Sci. Eng., B;MSBTEK;30/YR
Materials Science & Engineering, C: Biomimetic and Supramolecular Systems=Mater. Sci. Eng., C;MSCEEE;8/YR
Materials Science and Technology=Mater. Sci. Technol.;MSCTEP;M
Materials Science in Semiconductor Processing=Mater. Sci. Semicond. Process.;MSSPFQ;BM
Materials Transactions=Mater. Trans.;MTARCE;M
Matrix Biology=Matrix Biol.;MTBOEC;8/YR
Measurement Science and Technology=Meas. Sci. Technol.;MSTCEP;M
Mechanisms of Development=Mech. Dev.;MEDVE6;M
Medicinal Chemistry=Med. Chem.;MCEHAJ;6/YR
Medicinal Chemistry Research=Med. Chem. Res.;MCREEB;9/YR
Mendeleev Communications=Mendeleev Commun.;MENCEX;BM
Metabolic Engineering=Metab. Eng.;MEENFM;BM
Metabolism, Clinical and Experimental=Metab., Clin. Exp.;METAAJ;M
Metal Science and Heat Treatment=Met. Sci. Heat Treat.;MHTRAN;BM
Metallofizika i Noveishie Tekhnologii=Metallofiz. Noveishie Tekhnol.;MNTEEU;M
Metallurgical and Materials Transactions A: Physical Metallurgy and Materials Science=Metall. Mater. Trans. A;MMTAEB;M
Metallurgical and Materials Transactions B: Process Metallurgy and Materials Processing Science=Metall. Mater. Trans. B;MTBSEO;BM
Metally=Metally;MEALET;BM
Meteoritics & Planetary Science=Meteorit. Planet. Sci.;MPSCFY;M
Methods (San Diego, CA, United States)=Methods (San Diego, CA, U. S.);MTHDE9;M
Microbiology (New York, NY, United States)=Microbiology (N. Y., NY, U. S.);MIBLAO;BM
Microbiology (Reading, United Kingdom)=Microbiology (Reading, U. K.);MROBEO;M
Microbiology and Immunology=Microbiol. Immunol.;MIIMDV;M
Microchemical Journal=Microchem. J.;MICJAN;BM
Microchimica Acta=Microchim. Acta;MIACAQ;12/YR
Microelectronic Engineering=Microelectron. Eng.;MIENEF;8/YR
Microporous and Mesoporous Materials=Microporous Mesoporous Mater.;MIMMFJ;30/YR
Microscopy and Microanalysis=Microsc. Microanal.;MIMIF7;BM
Milchwissenschaft=Milchwissenschaft;MILCAD;4/YR
Mineralium Deposita=Miner. Deposita;MIDEBE;8/YR
Mineralogical Magazine=Mineral. Mag.;MNLMBB;BM
Mineralogy and Petrology=Mineral. Petrol.;MIPEE9;12/YR
Minerals & Metallurgical Processing=Miner. Metall. Process.;MMPRE8;Q
Minerals Engineering=Miner. Eng.;MENGEB;15/YR
Mini-Reviews in Medicinal Chemistry=Mini-Rev. Med. Chem.;MMCIAE;12/YR
Mini-Reviews in Organic Chemistry=Mini-Rev. Org. Chem.;MOCIBT;4/YR
Mitochondrion=Mitochondrion;MITOCN;BM
Modern Physics Letters B=Mod. Phys. Lett. B;MPLBET;30/YR
Molecular and Biochemical Parasitology=Mol. Biochem. Parasitol.;MBIPDP;M
Molecular and Cellular Biochemistry=Mol. Cell. Biochem.;MCBIB8;26/YR
Molecular and Cellular Biology=Mol. Cell. Biol.;MCEBD4;SM
Molecular and Cellular Endocrinology=Mol. Cell. Endocrinol.;MCEND6;30/YR
Molecular and Cellular Neuroscience=Mol. Cell. Neurosci.;MOCNED;M
Molecular and Cellular Probes=Mol. Cell. Probes;MCPRE6;BM
Molecular and Cellular Proteomics=Mol. Cell. Proteomics;MCPOBS;M
Molecular Biology (New York, NY, United States, English Edition)=Mol. Biol. (N. Y., NY, U. S., Engl. Ed.);MOLBBJ;BM
Molecular Biology and Evolution=Mol. Biol. Evol.;MBEVEO;M
Molecular Biology of the Cell=Mol. Biol. Cell;MBCEEV;M
Molecular Biology Reports=Mol. Biol. Rep.;MLBRBU;4/YR
Molecular BioSystems=Mol. BioSyst.;MBOIBW;6/YR
Molecular Biotechnology=Mol. Biotechnol.;MLBOEO;9/YR
Molecular Brain Research=Mol. Brain Res.;MBREE4;22/YR
Molecular Cancer Research=Mol. Cancer Res.;MCROC5;M
Molecular Cancer Therapeutics=Mol. Cancer Ther.;MCTOCF;M
Molecular Carcinogenesis=Mol. Carcinog.;MOCAE8;M
Molecular Cell=Mol. Cell;MOCEFL;SM
Molecular Crystals and Liquid Crystals=Mol. Cryst. Liq. Cryst.;MCLCD8;18/YR
Molecular Diversity=Mol. Diversity;MODIF4;4/YR
Molecular Endocrinology=Mol. Endocrinol.;MOENEN;M
Molecular Genetics and Genomics=Mol. Genet. Genomics;MGGOAA;M
Molecular Genetics and Metabolism=Mol. Genet. Metab.;MGMEFF;M
Molecular Immunology=Mol. Immunol.;MOIMD5;M
Molecular Membrane Biology=Mol. Membr. Biol.;MMEBE7;BM
Molecular Microbiology=Mol. Microbiol.;MOMIEE;23/YR
Molecular Neurobiology=Mol. Neurobiol.;MONBEW;BM
Molecular Pharmaceutics=Mol. Pharm.;MPOHBP;BM
Molecular Pharmacology=Mol. Pharmacol.;MOPMA3;M
Molecular Physics=Mol. Phys.;MOPHAM;SM
Molecular Plant-Microbe Interactions=Mol. Plant-Microbe Interact.;MPMIEL;M
Molecular Reproduction and Development=Mol. Reprod. Dev.;MREDEE;M
Molecular Simulation=Mol. Simul.;MOSIEA;15/YR
Molecular Therapy=Mol. Ther.;MTOHCK;M
Molecules=Molecules;MOLEFW;M
Molecules and Cells=Mol. Cells;MOCEEK;BM
Monatshefte fuer Chemie=Monatsh. Chem.;MOCMB7;M
Mutagenesis=Mutagenesis;MUTAEX;BM
Mutation Research=Mutat. Res.;MUREAV;18/YR
Nano Letters=Nano Lett.;NALEFD;M
NanoBiotechnology=NanoBiotechnology;NANOCG;4/YR
Nanomedicine=Nanomedicine;NANOBF;Q
Natural Product Reports=Nat. Prod. Rep.;NPRRDF;BM
Natural Product Research=Nat. Prod. Res.;NPRAAT;8/YR
Natural Product Sciences=Nat. Prod. Sci.;NPSCFB;Q
Nature (London, United Kingdom)=Nature (London, U. K.);NATUAS;W
Nature Biotechnology=Nat. Biotechnol.;NABIF9;M
Nature Cell Biology=Nat. Cell Biol.;NCBIFN;M
Nature Chemical Biology=Nat. Chem. Biol.;NCBABT;M
Nature Genetics=Nat. Genet.;NGENEC;M
Nature Immunology=Nat. Immunol.;NIAMCZ;M
Nature Materials=Nat. Mater.;NMAACR;M
Nature Medicine (New York, NY, United States)=Nat. Med. (N. Y., NY, U. S.);NAMEFI;M
Nature Methods=Nat. Methods;NMAEA3;M
Nature Neuroscience=Nat. Neurosci.;NANEFN;M
Nature Reviews Cancer=Nat. Rev. Cancer;NRCAC4;M
Nature Reviews Drug Discovery=Nat. Rev. Drug Discovery;NRDDAG;M
Nature Reviews Genetics=Nat. Rev. Genet.;NRGAAM;M
Nature Reviews Immunology=Nat. Rev. Immunol.;NRIABX;M
Nature Reviews Microbiology=Nat. Rev. Microbiol.;NRMACK;M
Nature Reviews Molecular Cell Biology=Nat. Rev. Mol. Cell Biol.;NRMCBP;M
Nature Reviews Neuroscience=Nat. Rev. Neurosci.;NRNAAN;M
Nature Structural & Molecular Biology=Nat. Struct. Mol. Biol.;NSMBCU;M
Naturwissenschaften=Naturwissenschaften;NATWAY;M
Naunyn-Schmiedeberg's Archives of Pharmacology=Naunyn-Schmiedeberg's Arch. Pharmacol.;NSAPCC;M
Neftekhimiya=Neftekhimiya;NEFTAH;BM
Neues Jahrbuch fuer Mineralogie, Abhandlungen=Neues Jahrb. Mineral., Abh.;NJMIAK;IRR
Neurochemical Research=Neurochem. Res.;NEREDZ;M
Neurochemistry International=Neurochem. Int.;NEUIDS;16/YR
Neuroendocrinology=Neuroendocrinology;NUNDAJ;M
NeuroImmunoModulation=NeuroImmunoModulation;NROIEM;BM
NeuroMolecular Medicine=NeuroMol. Med.;NMEEAN;6/YR
Neuron=Neuron;NERNET;SM
Neuropeptides (Amsterdam, Netherlands)=Neuropeptides (Amsterdam, Neth.);NRPPDD;BM
Neuropharmacology=Neuropharmacology;NEPHBW;16/YR
Neuroscience (Oxford, United Kingdom)=Neuroscience (Oxford, U. K.);NRSCDN;28/YR
Neuroscience Letters=Neurosci. Lett.;NELED5;57/YR
Neurosignals=Neurosignals;NEURIQ;BM
Neurotoxicology and Teratology=Neurotoxicol. Teratol.;NETEEC;BM
New Diamond and Frontier Carbon Technology=New Diamond Front. Carbon Technol.;NDFTFF;6/YR
New England Journal of Medicine=N. Engl. J. Med.;NEJMAG;W
New Journal of Chemistry=New J. Chem.;NJCHE5;M
Nihon Reoroji Gakkaishi=Nihon Reoroji Gakkaishi;NRGIAC;IRR
Nippon Kinzoku Gakkaishi=Nippon Kinzoku Gakkaishi;NIKGAV;M
Nitric Oxide=Nitric Oxide;NIOXF5;8/YR
Nordic Pulp & Paper Research Journal=Nord. Pulp Pap. Res. J.;NPPJEG;Q
Nuclear Engineering and Design=Nucl. Eng. Des.;NEDEAU;24/YR
Nuclear Fusion=Nucl. Fusion;NUFUAU;M
Nuclear Instruments & Methods in Physics Research, Section A: Accelerators, Spectrometers, Detectors, and Associated Equipment=Nucl. Instrum. Methods Phys. Res., Sect. A;NIMAER;36/YR
Nuclear Instruments & Methods in Physics Research, Section B: Beam Interactions with Materials and Atoms=Nucl. Instrum. Methods Phys. Res., Sect. B;NIMBEU;21/YR
Nuclear Medicine and Biology=Nucl. Med. Biol.;NMBIEO;8/YR
Nuclear Physics A=Nucl. Phys. A;NUPABL;68/YR
Nuclear Physics B=Nucl. Phys. B;NUPBBO;84/yr
Nuclear Physics B, Proceedings Supplements=Nucl. Phys. B, Proc. Suppl.;NPBSE7;IRR
Nuclear Science and Engineering=Nucl. Sci. Eng.;NSENAO;9/YR
Nuclear Technology=Nucl. Technol.;NUTYBB;M
Nucleic Acids Research=Nucleic Acids Res.;NARHAD;SM
Nucleic Acids Research Supplement=Nucleic Acids Res. Suppl.;NARSCE;A
Nucleosides, Nucleotides & Nucleic Acids=Nucleosides, Nucleotides Nucleic Acids;NNNAFY;M
Nukleonika=Nukleonika;NUKLAS;Q
Nutrition Research (New York, NY, United States)=Nutr. Res. (N. Y., NY, U. S.);NTRSDC;M
O'zbekiston Kimyo Jurnali=O'zb. Kim. J.;OKJZA6;BM
Oil, Gas (Hamburg, Germany)=Oil, Gas (Hamburg, Ger.);OGEMDJ;Q
Oligonucleotides=Oligonucleotides;OLIGAJ;Q
OMICS=OMICS;OMICAE;Q
Oncogene=Oncogene;ONCNES;58/YR
Optics and Spectroscopy=Opt. Spectrosc.;OPSUA3;M
Optics Communications=Opt. Commun.;OPCOB8;84/YR
Organic & Biomolecular Chemistry=Org. Biomol. Chem.;OBCRAK;24/YR
Organic Geochemistry=Org. Geochem.;ORGEDE;M
Organic Letters=Org. Lett.;ORLEF7;BW
Organic Preparations and Procedures International=Org. Prep. Proced. Int.;OPPIAK;BM
Organic Process Research & Development=Org. Process Res. Dev.;OPRDFK;BM
Organic Syntheses=Org. Synth.;ORSYAT;A
Organometallics=Organometallics;ORGND7;BW
Oriental Journal of Chemistry=Orient. J. Chem.;OJCHEG;3/YR
Oxidation Communications=Oxid. Commun.;OXCODW;4/YR
Oxidation of Metals=Oxid. Met.;OXMEAF;BM
Oyo Yakuri=Oyo Yakuri;OYYAA2;BM
Ozone: Science & Engineering=Ozone: Sci. Eng.;OZSEDS;BM
Particulate Science and Technology=Part. Sci. Technol.;PTCHDS;Q
Peptides (New York, NY, United States)=Peptides (N. Y., NY, U. S.);PPTDD5;M
Pest Management Science=Pest Manage. Sci.;PMSCFC;M
Pesticide Biochemistry and Physiology=Pestic. Biochem. Physiol.;PCBPBS;9/YR
Petroleum Science and Technology=Pet. Sci. Technol.;PSTEFV;M
Pfluegers Archiv=Pfluegers Arch.;PFLABK;M
Pharmaceutical Chemistry Journal=Pharm. Chem. J.;PCJOAU;M
Pharmaceutical Development and Technology=Pharm. Dev. Technol.;PDTEFS;Q
Pharmaceutical Research=Pharm. Res.;PHREEB;M
Pharmacogenetics and Genomics=Pharmacogenet. Genomics;PGHEAI;M
Pharmacogenomics Journal=Pharmacogenomics J.;PJHOAZ;BM
Pharmacology=Pharmacology;PHMGBN;12/YR
Pharmacology & Therapeutics=Pharmacol. Ther.;PHTHDT;M
Pharmacology, Biochemistry and Behavior=Pharmacol., Biochem. Behav.;PBBHAU;M
Pharmazie=Pharmazie;PHARAT;M
Phase Transitions=Phase Transitions;PHTRDP;M
Philosophical Magazine=Philos. Mag.;PMHABF;36/YR
Philosophical Magazine Letters=Philos. Mag. Lett.;PMLEEG;M
Phosphorus, Sulfur and Silicon and the Related Elements=Phosphorus, Sulfur Silicon Relat. Elem.;PSSLEC;M
Photochemical & Photobiological Sciences=Photochem. Photobiol. Sci.;PPSHCB;M
Photochemistry and Photobiology=Photochem. Photobiol.;PHCBAP;BM
Photosynthesis Research=Photosynth. Res.;PHRSDI;M
Physica B: Condensed Matter (Amsterdam, Netherlands)=Physica B (Amsterdam, Neth.);PHYBE3;16/YR
Physica C: Superconductivity and Its Applications (Amsterdam, Netherlands)=Physica C (Amsterdam, Neth.);PHYCE6;68/YR
Physica Scripta=Phys. Scr.;PHSTBO;M
Physica Scripta, T=Phys. Scr., T;PHSTER;IRR
Physica Status Solidi A: Applications and Materials Science=Phys. Status Solidi A;PSSABA;15/YR
Physica Status Solidi B: Basic Solid State Physics=Phys. Status Solidi B;PSSBBD;15/YR
Physica Status Solidi C: Conferences and Critical Reviews=Phys. Status Solidi C;PSSCGL;12/YR
Physical Chemistry Chemical Physics=Phys. Chem. Chem. Phys.;PPCPFQ;SM
Physical Review A: Atomic, Molecular, and Optical Physics=Phys. Rev. A: At., Mol., Opt. Phys.;PLRAAN;M
Physical Review B: Condensed Matter and Materials Physics=Phys. Rev. B: Condens. Matter Mater. Phys.;PRBMDO;48/YR
Physical Review C: Nuclear Physics=Phys. Rev. C: Nucl. Phys.;PRVCAN;M
Physical Review D: Particles and Fields=Phys. Rev. D: Part. Fields;PRVDAQ;SM
Physical Review E: Statistical, Nonlinear, and Soft Matter Physics=Phys. Rev. E: Stat., Nonlinear, Soft Matter Phys.;PRESCM;M
Physical Review Letters=Phys. Rev. Lett.;PRLTAO;W
Physics and Chemistry of Glasses=Phys. Chem. Glasses;PCGLA6;BM
Physics and Chemistry of Liquids=Phys. Chem. Liq.;PCLQAC;6/YR
Physics and Chemistry of Minerals=Phys. Chem. Miner.;PCMIDU;10/YR
Physics Letters A=Phys. Lett. A;PYLAAG;84/YR
Physics Letters B=Phys. Lett. B;PYLBAJ;W
Physics of Atomic Nuclei=Phys. At. Nucl.;PANUEO;M
Physics of Fluids=Phys. Fluids;PHFLE6;M
Physics of Plasmas=Phys. Plasmas;PHPAEN;M
Physics of the Solid State=Phys. Solid State;PSOSED;M
Physiologia Plantarum=Physiol. Plant.;PHPLAI;M
Physiology & Behavior=Physiol. Behav.;PHBHA4;15/YR
Phytochemical Analysis=Phytochem. Anal.;PHANEL;BM
Phytochemistry (Elsevier)=Phytochemistry (Elsevier);PYTCAS;SM
Phytochemistry Reviews=Phytochem. Rev.;PRHEBS;3/YR
Plant and Cell Physiology=Plant Cell Physiol.;PCPHA5;M
Plant and Soil=Plant Soil;PLSOA2;20/YR
Plant Cell=Plant Cell;PLCEEW;M
Plant Cell Reports=Plant Cell Rep.;PCRPD8;12/YR
Plant Growth Regulation=Plant Growth Regul.;PGRED3;9/YR
Plant Journal=Plant J.;PLJUED;24/YR
Plant Molecular Biology=Plant Mol. Biol.;PMBIDB;18/YR
Plant Physiology=Plant Physiol.;PLPHAY;M
Plant Physiology and Biochemistry (Amsterdam, Netherlands)=Plant Physiol. Biochem. (Amsterdam, Neth.);PPBIEX;M
Plant Science (Amsterdam, Netherlands)=Plant Sci. (Amsterdam, Neth.);PLSCE4;M
Planta=Planta;PLANAB;M
Planta Medica=Planta Med.;PLMEAA;M
Plasma Chemistry and Plasma Processing=Plasma Chem. Plasma Process.;PCPPDW;BM
Plasma Processes and Polymers=Plasma Processes Polym.;PPPLA6;9/YR
Plasmid=Plasmid;PLSMDX;BM
Plasticheskie Massy=Plast. Massy;PLMSAI;IRR
Plastics, Rubber and Composites=Plast., Rubber Compos.;PRUCFN;10/YR
Platelets=Platelets;PLTEEF;8/YR
PLoS Biology=PLoS Biol.;PBLIBG;M
PLoS Computational Biology=PLoS Comput. Biol.;PCBLBG;M
PLoS Genetics=PLoS Genet.;PGLEB5;M
PMSE Preprints=PMSE Prepr.;PPMRA9;SA
Polish Journal of Chemistry=Pol. J. Chem.;PJCHDQ;M
Polycyclic Aromatic Compounds=Polycyclic Aromat. Compd.;PARCEO;5/YR
Polyhedron=Polyhedron;PLYHDE;18/YR
Polymer=Polymer;POLMAG;BW
Polymer (Korea)=Polymer (Korea);POLLDG;BM
Polymer Bulletin (Heidelberg, Germany)=Polym. Bull. (Heidelberg, Ger.);POBUDR;M
Polymer Composites=Polym. Compos.;PCOMDI;BM
Polymer Degradation and Stability=Polym. Degrad. Stab.;PDSTDW;M
Polymer Engineering and Science=Polym. Eng. Sci.;PYESAZ;M
Polymer International=Polym. Int.;PLYIEI;M
Polymer Journal (Tokyo, Japan)=Polym. J. (Tokyo, Jpn.);POLJB8;M
Polymer Preprints (American Chemical Society, Division of Polymer Chemistry)=Polym. Prepr. (Am. Chem. Soc., Div. Polym. Chem.);ACPPAY;SA
Polymer Testing=Polym. Test.;POTEDZ;8/YR
Polymer-Plastics Technology and Engineering=Polym.-Plast. Technol. Eng.;PPTEC7;9/YR
Polymers & Polymer Composites=Polym. Polym. Compos.;PPOCEC;8/YR
Polymers for Advanced Technologies=Polym. Adv. Technol.;PADTE5;M
Poverkhnost=Poverkhnost;PFKMDJ;M
Powder Diffraction=Powder Diffr.;PODIE2;Q
Powder Metallurgy=Powder Metall.;PWMTAU;Q
Powder Metallurgy and Metal Ceramics=Powder Metall. Met. Ceram.;PMMCEF;BM
Powder Technology=Powder Technol.;POTEBX;33/YR
Practical Spectroscopy=Pract. Spectrosc.;PSPED9;IRR
Precambrian Research=Precambrian Res.;PCBRBY;32/YR
Preparative Biochemistry & Biotechnology=Prep. Biochem. Biotechnol.;PBBIF4;Q
Preprints - American Chemical Society, Division of Petroleum Chemistry=Prepr. - Am. Chem. Soc., Div. Pet. Chem.;ACPCAT;4/YR
Environ. Chem. Preprints of Extended Abstracts presented at the ACS National Meeting, American Chemical Society, Division of Environmental Chemistry=Prepr. Ext. Abstr. ACS Natl. Meet., Am. Chem. Soc., Div.;PEACF2;SA
Preprints of Symposia - American Chemical Society, Division of Fuel Chemistry=Prepr. Symp. - Am. Chem. Soc., Div. Fuel Chem.;PSADFZ;2/YR
Proceedings - Electrochemical Society=Proc. - Electrochem. Soc.;PESODO;IRR
Proceedings of the Estonian Academy of Sciences, Chemistry=Proc. Est. Acad. Sci., Chem.;PESCFO;Q
Proceedings of the National Academy of Sciences of the United States of America=Proc. Natl. Acad. Sci. U. S. A.;PNASA6;W
Process Biochemistry (Oxford, United Kingdom)=Process Biochem. (Oxford, U. K.);PBCHE5;12/YR
Process Safety and Environmental Protection=Process Saf. Environ. Prot.;PSEPEM;6/YR
Progress in Colloid & Polymer Science=Prog. Colloid Polym. Sci.;PCPSD7;IRR
Progress in Crystal Growth and Characterization of Materials=Prog. Cryst. Growth Charact. Mater.;PCGMED;BM
Progress in Inorganic Chemistry=Prog. Inorg. Chem.;PIOCAR;IRR
Progress in Nuclear Magnetic Resonance Spectroscopy=Prog. Nucl. Magn. Reson. Spectrosc.;PNMRAT;8/YR
Progress in Organic Coatings=Prog. Org. Coat.;POGCAT;12/YR
Progress in Polymer Science=Prog. Polym. Sci.;PRPSB8;M
Progress in Reaction Kinetics and Mechanism=Prog. React. Kinet. Mech.;PRKMF3;4/YR
Progress in Solid State Chemistry=Prog. Solid State Chem.;PSSTAW;Q
Progress in Surface Science=Prog. Surf. Sci.;PSSFBP;SM
Propellants, Explosives, Pyrotechnics=Propellants, Explos., Pyrotech.;PEPYD5;BM
Prostaglandins & Other Lipid Mediators=Prostaglandins Other Lipid Mediators;POLMFL;3/yr
Prostaglandins, Leukotrienes and Essential Fatty Acids=Prostaglandins, Leukotrienes Essent. Fatty Acids;PLEAEU;M
Protection of Metals=Prot. Met.;PTNMAR;BM
Protein and Peptide Letters=Protein Pept. Lett.;PPELEN;8/YR
Protein Engineering, Design & Selection=Protein Eng., Des. Sel.;PEDSBR;M
Protein Expression and Purification=Protein Expression Purif.;PEXPEJ;M
Protein Journal=Protein J.;PJROAH;8/YR
Protein Science=Protein Sci.;PRCIEI;M
Proteins: Structure, Function, and Bioinformatics=Proteins: Struct., Funct., Bioinf.;PSFBAF;16/YR
Proteomics=Proteomics;PROTC7;18/YR
Przemysl Chemiczny=Przem. Chem.;PRCHAB;M
Psychopharmacology (Berlin, Germany)=Psychopharmacology (Berlin, Ger.);PSCHDL;SM
Pteridines=Pteridines;PTRDEO;Q
Pulmonary Pharmacology & Therapeutics=Pulm. Pharmacol. Ther.;PPTHFJ;BM
Pure and Applied Chemistry=Pure Appl. Chem.;PACHAS;M
Purinergic Signalling=Purinergic Signalling;PSUIA9;Q
QSAR & Combinatorial Science=QSAR Comb. Sci.;QCSSAU;10/YR
Quantum Electronics=Quantum Electron.;QUELEZ;M
Quimica Nova=Quim. Nova;QUNODK;BM
Radiation Effects and Defects in Solids=Radiat. Eff. Defects Solids;REDSEI;M
Radiation Measurements=Radiat. Meas.;RMEAEP;BM
Radiation Physics and Chemistry=Radiat. Phys. Chem.;RPCHDM;18/YR
Radiation Research=Radiat. Res.;RAREAE;M
Radiochemistry (New York, NY, United States)=Radiochemistry (N. Y., NY, U. S.);RDIOEO;BM
Radiochimica Acta=Radiochim. Acta;RAACAP;12/YR
Radioprotection=Radioprotection;RAPRBA;Q
Ranliao Huaxue Xuebao=Ranliao Huaxue Xuebao;RHXUD8;BM
Rapid Communications in Mass Spectrometry=Rapid Commun. Mass Spectrom.;RCMSEF;SM
Rare Metals (Beijing, China)=Rare Met. (Beijing, China);RARME8;Q
Rasplavy=Rasplavy;RASPEM;BM
Reaction Kinetics and Catalysis Letters=React. Kinet. Catal. Lett.;RKCLAU;6/YR
Reactive & Functional Polymers=React. Funct. Polym.;RFPOF6;12/YR
Regulatory Peptides=Regul. Pept.;REPPDY;21/YR
Rengong Jingti Xuebao=Rengong Jingti Xuebao;RJXUEN;BM
Reproduction (Bristol, United Kingdom)=Reproduction (Bristol, U. K.);RCUKBS;M
Reproductive Toxicology=Reprod. Toxicol.;REPTED;BM
Research Communications in Biochemistry and Cell & Molecular Biology=Res. Commun. Biochem. Cell Mol. Biol.;RCBBFC;Q
Research Communications in Molecular Pathology and Pharmacology=Res. Commun. Mol. Pathol. Pharmacol.;RCMPE6;IRR
Research Communications in Pharmacology and Toxicology=Res. Commun. Pharmacol. Toxicol.;RCPTFY;Q
Research on Chemical Intermediates=Res. Chem. Intermed.;RCINEE;9/YR
Review of Scientific Instruments=Rev. Sci. Instrum.;RSINAK;M
Reviews in Analytical Chemistry=Rev. Anal. Chem.;RACYAX;4/YR
Reviews in Inorganic Chemistry=Rev. Inorg. Chem.;RICHD7;Q
Revista de Chimie (Bucharest, Romania)=Rev. Chim. (Bucharest, Rom.);RCBUAU;M
Revista de la Sociedad Quimica del Peru=Rev. Soc. Quim. Peru;RSQPAW;Q
Revista Mexicana de Ingenieria Quimica=Rev. Mex. Ing. Quim.;RMIQBM;3/YR
Revista Romana de Materiale=Rev. Rom. Mater.;RRMEB7;Q
Revue Roumaine de Chimie=Rev. Roum. Chim.;RRCHAX;M
Rheologica Acta=Rheol. Acta;RHEAAK;BM
RNA=RNA;RNARFU;M
RNA Biology=RNA Biol.;RBNIBE;BM
Romanian Journal of Physics=Rom. J. Phys.;RJPHEC;10/YR
Rossiiskii Khimicheskii Zhurnal=Ross. Khim. Zh.;RKZHEZ;BM
Rubber Chemistry and Technology=Rubber Chem. Technol.;RCTEA4;5/YR
Russian Chemical Bulletin=Russ. Chem. Bull.;RCBUEY;M
Russian Chemical Reviews=Russ. Chem. Rev.;RCRVAB;M
Russian Journal of Applied Chemistry=Russ. J. Appl. Chem.;RJACEO;M
Russian Journal of Bioorganic Chemistry=Russ. J. Bioorg. Chem.;RJBCET;BM
Russian Journal of Coordination Chemistry=Russ. J. Coord. Chem.;RJCCEY;M
Russian Journal of Electrochemistry=Russ. J. Electrochem.;RJELE3;M
Russian Journal of General Chemistry=Russ. J. Gen. Chem.;RJGCEK;M
Russian Journal of Genetics=Russ. J. Genet.;RJGEEQ;M
Russian Journal of Organic Chemistry=Russ. J. Org. Chem.;RJOCEQ;M
Russian Journal of Physical Chemistry=Russ. J. Phys. Chem.;RJPCAR;M
Russian Journal of Plant Physiology=Russ. J. Plant Physiol.;RJPPE2;BM
SAR and QSAR in Environmental Research=SAR QSAR Environ. Res.;SQERED;BM
Scandinavian Journal of Laboratory Animal Science=Scand. J. Lab. Anim. Sci.;SJLSE2;Q
Scandinavian Journal of Metallurgy=Scand. J. Metall.;SJMLAG;BM
Science (Washington, DC, United States)=Science (Washington, DC, U. S.);SCIEAS;W
Science in China, Series B: Chemistry=Sci. China, Ser. B: Chem.;SCBCFQ;BM
Science of the Total Environment=Sci. Total Environ.;STENDL;36/YR
Scripta Materialia=Scr. Mater.;SCMAF7;SM
Seibutsu Kogaku Kaishi=Seibutsu Kogaku Kaishi;SEKAEA;M
Semiconductor Science and Technology=Semicond. Sci. Technol.;SSTEET;M
Semiconductors=Semiconductors;SMICES;M
Sensors and Actuators, A: Physical=Sens. Actuators, A;SAAPEB;16/yr
Sensors and Actuators, B: Chemical=Sens. Actuators, B;SABCEB;BW
Separation and Purification Technology=Sep. Purif. Technol.;SPUTFP;18/yr
Separation Science and Technology=Sep. Sci. Technol.;SSTEDS;16/YR
Sepu=Sepu;SEPUER;BM
Shiyou Huagong=Shiyou Huagong;SHHUE8;M
Shiyou Xuebao, Shiyou Jiagong=Shiyou Xuebao, Shiyou Jiagong;SXSHEY;BM
Shuichuli Jishu=Shuichuli Jishu;SHJIEG;M
Signal Transduction=Signal Transduction;STIRCI;6/YR
Silicon Chemistry=Silicon Chem.;SCIHB4;BM
Small=Small;SMALBC;12/YR
Soft Matter=Soft Matter;SMOABF;6/YR
Soil Biology & Biochemistry=Soil Biol. Biochem.;SBIOAH;M
Soil Science=Soil Sci.;SOSCAK;M
Soil Science Society of America Journal=Soil Sci. Soc. Am. J.;SSSJD4;BM
Solar Energy Materials & Solar Cells=Sol. Energy Mater. Sol. Cells;SEMCEQ;20/YR
Solid State Communications=Solid State Commun.;SSCOA4;48/YR
Solid State Ionics=Solid State Ionics;SSIOD3;40/YR
Solid State Nuclear Magnetic Resonance=Solid State Nucl. Magn. Reson.;SSNRE4;8/YR
Solid State Sciences=Solid State Sci.;SSSCFJ;M
Solid-State Electronics=Solid-State Electron.;SSELA5;M
Solvent Extraction and Ion Exchange=Solvent Extr. Ion Exch.;SEIEDB;BM
Solvent Extraction Research and Development, Japan=Solvent Extr. Res. Dev., Jpn.;SERDEK;A
Somatic Cell and Molecular Genetics=Somatic Cell Mol. Genet.;SCMGDN;BM
South African Journal of Chemistry=S. Afr. J. Chem.;SAJCDG;IRR
SPE Production & Facilities=SPE Prod. Facil.;SPRFEZ;Q
SPE Reservoir Evaluation & Engineering=SPE Reservoir Eval. Eng.;SREEFG;BM
Spectrochimica Acta, Part A: Molecular and Biomolecular Spectroscopy=Spectrochim. Acta, Part A;SAMCAS;14/YR
Spectrochimica Acta, Part B: Atomic Spectroscopy=Spectrochim. Acta, Part B;SAASBH;M
Spectroscopy (Amsterdam, Netherlands)=Spectroscopy (Amsterdam, Neth.);SPIJDZ;6/YR
Spectroscopy Letters=Spectrosc. Lett.;SPLEBX;6/YR
STAL, Sciences et Techniques de l'Animal de Laboratoire=STAL, Sci. Tech. Anim. Lab.;STALDT;Q
Starch/Staerke=Starch/Staerke;STARDD;M
Steel Research International=Steel Res. Int.;SRITB9;M
Steroids=Steroids;STEDAM;M
Structural Chemistry=Struct. Chem.;STCHES;BM
Structure (Cambridge, MA, United States)=Structure (Cambridge, MA, U. S.);STRUE6;M
Superconductor Science and Technology=Supercond. Sci. Technol.;SUSTEF;M
Superlattices and Microstructures=Superlattices Microstruct.;SUMIEK;M
Supramolecular Chemistry=Supramol. Chem.;SCHEER;8/YR
Surface and Coatings Technology=Surf. Coat. Technol.;SCTEEJ;39/YR
Surface and Interface Analysis=Surf. Interface Anal.;SIANDQ;13/YR
Surface Engineering=Surf. Eng.;SUENET;6/YR
Surface Review and Letters=Surf. Rev. Lett.;SRLEFH;BM
Surface Science=Surf. Sci.;SUSCAS;36/YR
Surface Science Reports=Surf. Sci. Rep.;SSREDI;32/YR
Synapse (New York, NY, United States)=Synapse (N. Y., NY, U. S.);SYNAET;16/YR
Synlett=Synlett;SYNLES;20/YR
Synthesis=Synthesis;SYNTBF;20/YR
Synthesis and Reactivity in Inorganic, Metal-Organic, and Nano-Metal Chemistry=Synth. React. Inorg., Met.-Org., Nano-Met. Chem.;SRIMDO;10/YR
Synthetic Communications=Synth. Commun.;SYNCAV;SM
Synthetic Lubrication=Synth. Lubr.;SYLUEB;Q
Synthetic Metals=Synth. Met.;SYMEDZ;24/YR
Taehan Kumsok, Chaeryo Hakhoechi=Taehan Kumsok, Chaeryo Hakhoechi;TKHABB;M
Talanta=Talanta;TLNTA2;M
Tappi Journal=Tappi J.;TAJODT;M
Technical Physics=Tech. Phys.;TEPHEX;M
Technical Physics Letters=Tech. Phys. Lett.;TPLEED;M
Tenside, Surfactants, Detergents=Tenside, Surfactants, Deterg.;TSDEES;BM
Tetrahedron=Tetrahedron;TETRAB;W
Tetrahedron Letters=Tetrahedron Lett.;TELEAY;W
Tetrahedron: Asymmetry=Tetrahedron: Asymmetry;TASYE3;SM
Tetsu to Hagane=Tetsu to Hagane;TEHAA2;M
Textile Research Journal=Text. Res. J.;TRJOA9;M
THEOCHEM=THEOCHEM;THEODJ;72/YR
Theoretical and Experimental Chemistry=Theor. Exp. Chem.;TEXCAK;BM
Theoretical Chemistry Accounts=Theor. Chem. Acc.;TCACFW;10/YR
Theoretical Foundations of Chemical Engineering=Theor. Found. Chem. Eng.;TFCEAU;BM
Thermochimica Acta=Thermochim. Acta;THACAS;SM
Thin Solid Films=Thin Solid Films;THSFAP;46/YR
Thrombosis and Haemostasis=Thromb. Haemostasis;THHADQ;M
Thrombosis Research=Thromb. Res.;THBRAA;M
Topics in Catalysis=Top. Catal.;TOCAFI;20/YR
Toxicological and Environmental Chemistry=Toxicol. Environ. Chem.;TECSDY;BM
Toxicological Sciences=Toxicol. Sci.;TOSCF2;M
Toxicology=Toxicology;TXCYAC;42/YR
Toxicology and Applied Pharmacology=Toxicol. Appl. Pharmacol.;TXAPA9;SM
Toxicology in Vitro=Toxicol. in Vitro;TIVIEQ;8/YR
Toxicology Letters=Toxicol. Lett.;TOLED5;24/YR
Toxicology Mechanisms and Methods=Toxicol. Mech. Methods;TMMOCP;BM
Toxicon=Toxicon;TOXIA6;16/YR
TrAC, Trends in Analytical Chemistry=TrAC, Trends Anal. Chem.;TTAEDJ;11/YR
Traffic (Oxford, United Kingdom)=Traffic (Oxford, U. K.);TRAFFA;M
Transactions of the Indian Ceramic Society=Trans. Indian Ceram. Soc.;TICSAP;Q
Transactions of the Institute of Metal Finishing=Trans. Inst. Met. Finish.;TIMFA2;BM
Transactions of the SAEST=Trans. SAEST;TSETA6;Q
Transgenic Research=Transgenic Res.;TRSEES;BM
Transition Metal Chemistry (Dordrecht, Netherlands)=Transition Met. Chem. (Dordrecht, Neth.);TMCHDN;8/YR
Trends in Biochemical Sciences=Trends Biochem. Sci.;TBSCDB;M
Trends in Biotechnology=Trends Biotechnol.;TRBIDM;M
Trends in Endocrinology and Metabolism=Trends Endocrinol. Metab.;TENME4;10/YR
Trends in Food Science & Technology=Trends Food Sci. Technol.;TFTEEH;M
Trends in Genetics=Trends Genet.;TRGEE2;M
Trends in Immunology=Trends Immunol.;TIRMAE;M
Trends in Microbiology=Trends Microbiol.;TRMIEA;M
Trends in Neurosciences=Trends Neurosci.;TNSCDR;M
Trends in Pharmacological Sciences=Trends Pharmacol. Sci.;TPHSDY;M
Trends in Plant Science=Trends Plant Sci.;TPSCF9;M
Tribology Transactions=Tribol. Trans.;TRTRE4;Q
Turkish Journal of Chemistry=Turk. J. Chem.;TJCHE3;6/YR
Ukrains'kii Biokhimichnii Zhurnal=Ukr. Biokhim. Zh.;UBZKAA;BM
Ukrains'kii Fizichnii Zhurnal=Ukr. Fiz. Zh.;UFZHFY;M
Ukrainskii Khimicheskii Zhurnal (Russian Edition)=Ukr. Khim. Zh. (Russ. Ed.);UKZHAU;6/YR
Ultramicroscopy=Ultramicroscopy;ULTRD6;16/YR
Ultrasonics Sonochemistry=Ultrason. Sonochem.;ULSOER;BM
Vacuum=Vacuum;VACUAV;16/yr
Vascular Pharmacology=Vasc. Pharmacol.;VPAHAJ;M
Vestnik Moskovskogo Universiteta, Seriya 2: Khimiya=Vestn. Mosk. Univ., Ser. 2: Khim.;VMUKA5;BM
Vestnik Sankt-Peterburgskogo Universiteta, Seriya 4: Fizika, Khimiya=Vestn. S.-Peterb. Univ., Ser. 4: Fiz., Khim.;VSUKEH;Q
Vestsi Natsyyanal'nai Akademii Navuk Belarusi, Seryya Khimichnykh Navuk=Vestsi Nats. Akad. Navuk Belarusi, Ser. Khim. Navuk;VNBNFX;Q
Vibrational Spectroscopy=Vib. Spectrosc.;VISPEK;BM
Viral Immunology=Viral Immunol.;VIIMET;Q
Virology=Virology;VIRLAX;26/YR
Virus Genes=Virus Genes;VIGEET;BM
Virus Research=Virus Res.;VIREDF;M
Vysokomolekulyarnye Soedineniya, Seriya A i Seriya B=Vysokomol. Soedin., Ser. A Ser. B;VSSBEE;M
Water Environment Research=Water Environ. Res.;WAERED;7/YR
Water Quality Research Journal of Canada=Water Qual. Res. J. Can.;WQRCFA;Q
Water Research=Water Res.;WATRAG;20/YR
Water Resources=Water Resour.;WARED4;BM
Water, Air, & Soil Pollution=Water, Air, Soil Pollut.;WAPLAC;36/YR
Wear=Wear;WEARAH;M
Weed Science=Weed Sci.;WEESA6;BM
Wood and Fiber Science=Wood Fiber Sci.;WFSCD4;Q
Wood Science and Technology=Wood Sci. Technol.;WOSTBE;8/YR
Wuji Huaxue Xuebao=Wuji Huaxue Xuebao;WHUXEO;M
Wuli Huaxue Xuebao=Wuli Huaxue Xuebao;WHXUEU;M
Wuli Xuebao=Wuli Xuebao;WLHPAR;M
X-Ray Spectrometry=X-Ray Spectrom.;XRSPAX;BM
X-Ray Structure Analysis Online=X-Ray Struct. Anal. Online;XSAOAF;IRR
Xenobiotica=Xenobiotica;XENOBH;M
Yakhak Hoechi=Yakhak Hoechi;YAHOA3;BM
Yakugaku Zasshi=Yakugaku Zasshi;YKKZAJ;M
Yeast=Yeast;YESTE3;16/YR
Yingyong Huaxue=Yingyong Huaxue;YIHUED;M
Yosetsu Gakkai Ronbunshu=Yosetsu Gakkai Ronbunshu;YGRODU;Q
Youji Huaxue=Youji Huaxue;YCHHDX;M
Yuki Gosei Kagaku Kyokaishi=Yuki Gosei Kagaku Kyokaishi;YGKKAE;M
Zeitschrift fuer Anorganische und Allgemeine Chemie=Z. Anorg. Allg. Chem.;ZAACAB;M
Zeitschrift fuer Kristallographie=Z. Kristallogr.;ZEKRDZ;12/YR
Zeitschrift fuer Kristallographie - New Crystal Structures=Z. Kristallogr. - New Cryst. Struct.;ZKNSFT;4/YR
Zeitschrift fuer Metallkunde=Z. Metallkd.;ZEMTAE;M
Zeitschrift fuer Naturforschung, A: Physical Sciences=Z. Naturforsch., A: Phys. Sci.;ZNASEI;M
Zeitschrift fuer Naturforschung, B: Chemical Sciences=Z. Naturforsch., B: Chem. Sci.;ZNBSEN;M
Zeitschrift fuer Naturforschung, C: Journal of Biosciences=Z. Naturforsch., C: J. Biosci.;ZNCBDA;BM
Zeitschrift fuer Physikalische Chemie (Muenchen, Germany)=Z. Phys. Chem. (Muenchen, Ger.);ZPCFAX;12/YR
Zhipu Xuebao=Zhipu Xuebao;ZXHUBO;Q
Zhongguo Shengwu Huaxue Yu Fenzi Shengwu Xuebao=Zhongguo Shengwu Huaxue Yu Fenzi Shengwu Xuebao;ZSHXF2;BM
Zhurnal Neorganicheskoi Khimii=Zh. Neorg. Khim.;ZNOKAQ;M
Zhurnal Organichnoi ta Farmatsevtichnoi Khimii=Zh. Org. Farm. Khim.;ZOFKAM;4/YR
